UNRANK,링크,7,7,0,1.0
UNRANK,선인장,10,10,0,1.0
UNRANK,컷 트리,7,7,0,1.0
UNRANK,z,8,7,1,0.875
UNRANK,안정 결혼 문제,7,6,1,0.8571428571428571
UNRANK,오프라인 동적 연결성 판정,6,5,1,0.8333333333333334
UNRANK,오일러 지표 (χ=v-e+f),117,88,29,0.7521367521367521
UNRANK,퍼시스턴트 세그먼트 트리,4,3,1,0.75
UNRANK,4차원 이상의 기하학,31,22,9,0.7096774193548387
UNRANK,반평면 교집합,3,2,1,0.6666666666666666
UNRANK,기하학,27122,17317,9805,0.6384853624363985
UNRANK,이중 연결 요소,11,7,4,0.6363636363636364
UNRANK,구현,667950,424372,243578,0.6353349801631859
UNRANK,사칙연산,388059,239780,148279,0.6178957323499777
UNRANK,수학,597225,353903,243322,0.5925790112604128
UNRANK,보로노이 다이어그램,7,4,3,0.5714285714285714
UNRANK,문자열,87532,49539,37993,0.5659530228944843
UNRANK,확장 유클리드 호제법,23,13,10,0.5652173913043478
UNRANK,순열 사이클 분할,173,97,76,0.5606936416184971
UNRANK,재귀,9778,5473,4305,0.5597259153201064
UNRANK,런타임 전의 전처리,371,203,168,0.5471698113207547
UNRANK,파싱,4096,2233,1863,0.545166015625
UNRANK,단절점과 단절선,152,82,70,0.5394736842105263
UNRANK,확률론,136,73,63,0.5367647058823529
UNRANK,스플레이 트리,82,44,38,0.5365853658536586
UNRANK,오일러 경로 테크닉,41,22,19,0.5365853658536586
UNRANK,백트래킹,20091,10540,9551,0.5246130108008561
UNRANK,피타고라스 정리,2979,1562,1417,0.5243370258475999
UNRANK,큐,8275,4307,3968,0.5204833836858006
UNRANK,분할 정복,5269,2732,2537,0.5185044600493453
UNRANK,조합론,5341,2767,2574,0.5180677775697435
UNRANK,게임 이론,720,368,352,0.5111111111111111
UNRANK,heavy-light 분할,49,25,24,0.5102040816326531
UNRANK,최소 공통 조상,821,417,404,0.5079171741778319
UNRANK,브루트포스 알고리즘,57714,29265,28449,0.5070693419274352
UNRANK,희소 배열,580,294,286,0.506896551724138
UNRANK,회전하는 캘리퍼스,93,47,46,0.5053763440860215
UNRANK,함수 개형을 이용한 최적화,14,7,7,0.5
UNRANK,통계학,2,1,1,0.5
UNRANK,병렬 이분 탐색,4,2,2,0.5
UNRANK,번사이드 보조정리,2,1,1,0.5
UNRANK,델로네 삼각분할,2,1,1,0.5
UNRANK,플로이드–와샬,1771,881,890,0.49745906267645396
UNRANK,휴리스틱,425,209,216,0.49176470588235294
UNRANK,유클리드 호제법,6075,2956,3119,0.4865843621399177
UNRANK,선형대수학,566,272,294,0.48056537102473496
UNRANK,트리,5090,2442,2648,0.47976424361493125
UNRANK,덱,3747,1795,1952,0.47904990659194024
UNRANK,2-sat,65,31,34,0.47692307692307695
UNRANK,큰 수 연산,6633,3161,3472,0.4765566108849691
UNRANK,임의 정밀도,6633,3161,3472,0.4765566108849691
UNRANK,라빈–카프,80,38,42,0.475
UNRANK,해시를 사용한 집합과 맵,5477,2576,2901,0.4703304728866168
UNRANK,정렬,57122,26844,30278,0.46994152865796013
UNRANK,트리를 사용한 집합과 맵,1411,663,748,0.46987951807228917
UNRANK,최소 스패닝 트리,1816,853,963,0.4697136563876652
UNRANK,시뮬레이션,19186,8918,10268,0.46481809652871886
UNRANK,트리에서의 다이나믹 프로그래밍,454,211,243,0.4647577092511013
UNRANK,깊이 우선 탐색,22691,10482,12209,0.46194526464236924
UNRANK,가우스 소거법,13,6,7,0.46153846153846156
UNRANK,비둘기집 원리,76,35,41,0.4605263157894737
UNRANK,스택,22188,10120,12068,0.45610239769244637
UNRANK,다이나믹 프로그래밍,53892,24324,29568,0.4513471387218882
UNRANK,그리디 알고리즘,36736,16573,20163,0.45113784843205573
UNRANK,위상 정렬,1530,689,841,0.4503267973856209
UNRANK,덱을 이용한 다이나믹 프로그래밍,9,4,5,0.4444444444444444
UNRANK,자료 구조,57638,25607,32031,0.4442728755335022
UNRANK,오프라인 쿼리,254,112,142,0.4409448818897638
UNRANK,이분 매칭,347,153,194,0.4409221902017291
UNRANK,너비 우선 탐색,39967,17605,22362,0.44048840293241925
UNRANK,정수론,39060,17025,22035,0.4358678955453149
UNRANK,그래프 탐색,46730,20313,26417,0.4346886368499893
UNRANK,접미사 배열과 lcp 배열,113,49,64,0.4336283185840708
UNRANK,그래프 이론,57713,24791,32922,0.4295565990331468
UNRANK,머지 소트 트리,126,54,72,0.42857142857142855
UNRANK,센트로이드 분할,14,6,8,0.42857142857142855
UNRANK,비트 집합,35,15,20,0.42857142857142855
UNRANK,오일러 피 함수,61,26,35,0.4262295081967213
UNRANK,좌표 압축,1967,835,1132,0.4245043213014743
UNRANK,값,1967,835,1132,0.4245043213014743
UNRANK,비트마스킹,2699,1145,1554,0.42423119673953313
UNRANK,볼록 껍질,281,118,163,0.4199288256227758
UNRANK,오목 다각형 내부의 점 판정,12,5,7,0.4166666666666667
UNRANK,소수 판정,26631,11077,15554,0.4159438248657579
UNRANK,폴라드 로,94,39,55,0.4148936170212766
UNRANK,가장 긴 증가하는 부분 수열: o(n log n),1109,456,653,0.41118124436429215
UNRANK,선분 교차 판정,323,132,191,0.4086687306501548
UNRANK,밀러–라빈 소수 판별법,150,61,89,0.4066666666666667
UNRANK,mo's,74,30,44,0.40540540540540543
UNRANK,삼분 탐색,74,30,44,0.40540540540540543
UNRANK,센트로이드,15,6,9,0.4
UNRANK,0-1 너비 우선 탐색,827,326,501,0.3941958887545345
UNRANK,정규 표현식,453,174,279,0.3841059602649007
UNRANK,페르마의 소정리,327,125,202,0.382262996941896
UNRANK,에라토스테네스의 체,19087,7288,11799,0.3818305653062294
UNRANK,트라이,516,197,319,0.3817829457364341
UNRANK,비트필드를 이용한 다이나믹 프로그래밍,512,195,317,0.380859375
UNRANK,두 포인터,6397,2416,3981,0.3776770361106769
UNRANK,누적 합,5204,1958,3246,0.3762490392006149
UNRANK,연결 리스트,2039,767,1272,0.37616478666012754
UNRANK,기댓값의 선형성,24,9,15,0.375
UNRANK,뤼카 정리,16,6,10,0.375
UNRANK,세그먼트 트리,3706,1385,2321,0.3737182946573125
UNRANK,배낭 문제,2335,871,1464,0.3730192719486081
UNRANK,모듈로 곱셈 역원,325,121,204,0.3723076923076923
UNRANK,kmp,606,225,381,0.3712871287128713
UNRANK,우선순위 큐,7142,2640,4502,0.36964435732287876
UNRANK,슬라이딩 윈도우,1313,485,828,0.3693830921553694
UNRANK,강한 연결 요소,285,105,180,0.3684210526315789
UNRANK,볼록 다각형 내부의 점 판정,33,12,21,0.36363636363636365
UNRANK,해싱,132,48,84,0.36363636363636365
UNRANK,다익스트라,7059,2517,4542,0.3565660858478538
UNRANK,분리 집합,2675,949,1726,0.3547663551401869
UNRANK,구성적,564,200,364,0.3546099290780142
UNRANK,외판원 순회 문제,732,259,473,0.35382513661202186
UNRANK,이분 탐색,17834,6293,11541,0.3528653134462263
UNRANK,다각형의 넓이,173,60,113,0.3468208092485549
UNRANK,최대 유량 최소 컷 정리,32,11,21,0.34375
UNRANK,매개 변수 탐색,6847,2333,4514,0.34073316781072005
UNRANK,애드 혹,1477,502,975,0.33987813134732564
UNRANK,느리게 갱신되는 세그먼트 트리,343,116,227,0.33819241982507287
UNRANK,분할 정복을 이용한 거듭제곱,2064,694,1370,0.33624031007751937
UNRANK,크누스 최적화,3,1,2,0.3333333333333333
UNRANK,분할 정복을 사용한 최적화,3,1,2,0.3333333333333333
UNRANK,중간에서 만나기,419,139,280,0.3317422434367542
UNRANK,벨만–포드,573,190,383,0.33158813263525305
UNRANK,최대 유량,275,90,185,0.32727272727272727
UNRANK,중국인의 나머지 정리,431,140,291,0.3248259860788863
UNRANK,담금질 기법,78,25,53,0.32051282051282054
UNRANK,많은 조건 분기,1959,625,1334,0.31904032669729454
UNRANK,양방향 탐색,22,7,15,0.3181818181818182
UNRANK,작은 집합에서 큰 집합으로 합치는 테크닉,23,7,16,0.30434782608695654
UNRANK,매트로이드,10,3,7,0.3
UNRANK,다차원 세그먼트 트리,17,5,12,0.29411764705882354
UNRANK,제곱근 분할법,34,10,24,0.29411764705882354
UNRANK,스위핑,1040,303,737,0.29134615384615387
UNRANK,최소 비용 최대 유량,52,15,37,0.28846153846153844
UNRANK,3차원 기하학,72,20,52,0.2777777777777778
UNRANK,평면 그래프,11,3,8,0.2727272727272727
UNRANK,스프라그–그런디 정리,79,20,59,0.25316455696202533
UNRANK,아호-코라식,64,16,48,0.25
UNRANK,볼록 껍질을 이용한 최적화,56,14,42,0.25
UNRANK,고속 푸리에 변환,65,16,49,0.24615384615384617
UNRANK,미적분학,76,18,58,0.23684210526315788
UNRANK,포함 배제의 원리,76,16,60,0.21052631578947367
UNRANK,쌍대 그래프,10,2,8,0.2
UNRANK,오일러 경로,40,7,33,0.175
UNRANK,무작위화,123,19,104,0.15447154471544716
UNRANK,매내처,22,3,19,0.13636363636363635
UNRANK,수치해석,401,31,370,0.0773067331670823
UNRANK,물리학,16,1,15,0.0625
UNRANK,최소 외접원,277,6,271,0.021660649819494584
UNRANK,크누스 x,3,0,3,0.0
UNRANK,🏃🤔,4,0,4,0.0
UNRANK,뫼비우스 반전 공식,3,0,3,0.0
UNRANK,회문 트리,6,0,6,0.0
UNRANK,aliens 트릭,3,0,3,0.0
UNRANK,🧑‍💻,4,0,4,0.0
UNRANK,인터프리터,1,0,1,0.0
UNRANK,헝가리안,2,0,2,0.0
UNRANK,벌래캠프–매시,1,0,1,0.0
UNRANK,히르쉬버그,2,0,2,0.0
UNRANK,🌎👨‍💻📄🎱📖🧪,4,0,4,0.0
UNRANK,춤추는 링크,3,0,3,0.0
UNRANK,단조 큐를 이용한 최적화,3,0,3,0.0
UNRANK,로프,2,0,2,0.0
UNRANK,🧵,4,0,4,0.0
골드 1,계산 이론,1,1,0,1.0
골드 1,선인장,1,1,0,1.0
골드 1,오목 다각형 내부의 점 판정,1,1,0,1.0
골드 1,번사이드 보조정리,2,2,0,1.0
골드 1,이중 연결 요소,1,1,0,1.0
골드 1,휴리스틱,63,55,8,0.873015873015873
골드 1,오일러 지표 (χ=v-e+f),46,40,6,0.8695652173913043
골드 1,사칙연산,17237,13141,4096,0.7623716423971689
골드 1,담금질 기법,7,5,2,0.7142857142857143
골드 1,큐,3479,2406,1073,0.6915780396665708
골드 1,피타고라스 정리,710,485,225,0.6830985915492958
골드 1,기댓값의 선형성,22,15,7,0.6818181818181818
골드 1,병렬 이분 탐색,3,2,1,0.6666666666666666
골드 1,3차원 기하학,124,80,44,0.6451612903225806
골드 1,순열 사이클 분할,121,77,44,0.6363636363636364
골드 1,재귀,8454,5375,3079,0.6357937071208896
골드 1,수학,62264,38510,23754,0.6184954387768212
골드 1,구현,82530,50966,31564,0.6175451351023871
골드 1,게임 이론,1065,648,417,0.6084507042253521
골드 1,최소 비용 최대 유량,20,12,8,0.6
골드 1,조합론,6032,3590,2442,0.5951591511936339
골드 1,유클리드 호제법,2144,1260,884,0.5876865671641791
골드 1,문자열,25060,14602,10458,0.5826815642458101
골드 1,백트래킹,23707,13643,10064,0.5754840342514869
골드 1,플로이드–와샬,4684,2689,1995,0.5740819812126388
골드 1,z,14,8,6,0.5714285714285714
골드 1,분할 정복,5678,3237,2441,0.5700951039098274
골드 1,큰 수 연산,3192,1817,1375,0.5692355889724311
골드 1,임의 정밀도,3192,1817,1375,0.5692355889724311
골드 1,최소 스패닝 트리,4410,2491,1919,0.5648526077097505
골드 1,시뮬레이션,24131,13630,10501,0.5648336165098835
골드 1,위상 정렬,3377,1895,1482,0.5611489487710986
골드 1,매내처,52,29,23,0.5576923076923077
골드 1,해시를 사용한 집합과 맵,6279,3491,2788,0.5559802516324256
골드 1,정수론,12754,6874,5880,0.5389681668496158
골드 1,스택,10233,5513,4720,0.5387471904622301
골드 1,에라토스테네스의 체,4823,2581,2242,0.5351441011818371
골드 1,브루트포스 알고리즘,40629,21605,19024,0.5317630264097074
골드 1,소수 판정,5968,3172,2796,0.5315013404825737
골드 1,정렬,28957,15324,13633,0.5291984666919916
골드 1,모듈로 곱셈 역원,555,293,262,0.527927927927928
골드 1,연결 리스트,888,466,422,0.5247747747747747
골드 1,다이나믹 프로그래밍,51403,26942,24461,0.5241328327140439
골드 1,확장 유클리드 호제법,105,55,50,0.5238095238095238
골드 1,폴라드 로,48,25,23,0.5208333333333334
골드 1,오일러 피 함수,104,54,50,0.5192307692307693
골드 1,페르마의 소정리,530,275,255,0.5188679245283019
골드 1,선형대수학,745,383,362,0.5140939597315436
골드 1,런타임 전의 전처리,221,113,108,0.5113122171945701
골드 1,값,959,490,469,0.5109489051094891
골드 1,좌표 압축,959,490,469,0.5109489051094891
골드 1,비트 집합,49,25,24,0.5102040816326531
골드 1,덱,3106,1578,1528,0.5080489375402447
골드 1,그리디 알고리즘,23129,11734,11395,0.5073284621038523
골드 1,트리,10158,5093,5065,0.5013782240598543
골드 1,기하학,5823,2919,2904,0.5012879958784132
골드 1,파싱,3336,1671,1665,0.5008992805755396
골드 1,그린 정리,2,1,1,0.5
골드 1,최소 외접원,6,3,3,0.5
골드 1,볼록 다각형 내부의 점 판정,6,3,3,0.5
골드 1,깊이 우선 탐색,26855,13425,13430,0.49990690746602123
골드 1,자료 구조,47228,23570,23658,0.49906834928432287
골드 1,배낭 문제,3209,1599,1610,0.4982860704269243
골드 1,너비 우선 탐색,51163,25031,26132,0.48924027128979924
골드 1,비트마스킹,5674,2727,2947,0.4806133239337328
골드 1,그래프 이론,92553,44367,48186,0.4793685780039545
골드 1,그래프 탐색,68456,32810,35646,0.4792859647072572
골드 1,정규 표현식,657,314,343,0.4779299847792998
골드 1,누적 합,6390,3048,3342,0.47699530516431926
골드 1,삼분 탐색,87,41,46,0.47126436781609193
골드 1,스프라그–그런디 정리,85,40,45,0.47058823529411764
골드 1,우선순위 큐,9634,4529,5105,0.47010587502594975
골드 1,단절점과 단절선,145,68,77,0.4689655172413793
골드 1,슬라이딩 윈도우,2058,961,1097,0.46695821185617103
골드 1,비둘기집 원리,69,32,37,0.463768115942029
골드 1,트리를 사용한 집합과 맵,3160,1458,1702,0.46139240506329116
골드 1,최소 공통 조상,881,403,478,0.45743473325766176
골드 1,확률론,232,106,126,0.45689655172413796
골드 1,분할 정복을 이용한 거듭제곱,3169,1439,1730,0.4540864626065005
골드 1,두 포인터,10467,4750,5717,0.4538072035922423
골드 1,가장 긴 증가하는 부분 수열: o(n log n),2601,1167,1434,0.4486735870818916
골드 1,외판원 순회 문제,1148,515,633,0.44860627177700346
골드 1,kmp,1079,484,595,0.448563484708063
골드 1,트라이,878,390,488,0.44419134396355353
골드 1,이분 매칭,445,196,249,0.4404494382022472
골드 1,뤼카 정리,103,45,58,0.4368932038834951
골드 1,트리에서의 다이나믹 프로그래밍,1160,506,654,0.4362068965517241
골드 1,최대 유량,253,109,144,0.4308300395256917
골드 1,안정 결혼 문제,7,3,4,0.42857142857142855
골드 1,스위핑,1249,531,718,0.42514011208967173
골드 1,희소 배열,552,234,318,0.42391304347826086
골드 1,다익스트라,14119,5981,8138,0.42361357036617325
골드 1,비트필드를 이용한 다이나믹 프로그래밍,1121,471,650,0.4201605709188225
골드 1,이분 탐색,19915,8305,11610,0.41702234496610596
골드 1,분리 집합,6585,2719,3866,0.41290812452543657
골드 1,세그먼트 트리,3839,1560,2279,0.4063558218286012
골드 1,구성적,959,389,570,0.4056308654848801
골드 1,0-1 너비 우선 탐색,2439,988,1451,0.4050840508405084
골드 1,매개 변수 탐색,6416,2576,3840,0.4014962593516209
골드 1,볼록 껍질을 이용한 최적화,5,2,3,0.4
골드 1,미적분학,179,71,108,0.39664804469273746
골드 1,애드 혹,1954,767,1187,0.3925281473899693
골드 1,느리게 갱신되는 세그먼트 트리,192,75,117,0.390625
골드 1,함수 개형을 이용한 최적화,18,7,11,0.3888888888888889
골드 1,중국인의 나머지 정리,650,252,398,0.38769230769230767
골드 1,mo's,66,25,41,0.3787878787878788
골드 1,볼록 껍질,234,86,148,0.36752136752136755
골드 1,무작위화,44,16,28,0.36363636363636365
골드 1,회전하는 캘리퍼스,34,12,22,0.35294117647058826
골드 1,많은 조건 분기,2858,1005,1853,0.3516445066480056
골드 1,밀러–라빈 소수 판별법,124,43,81,0.3467741935483871
골드 1,강한 연결 요소,243,84,159,0.345679012345679
골드 1,작은 집합에서 큰 집합으로 합치는 테크닉,6,2,4,0.3333333333333333
골드 1,중간에서 만나기,1048,348,700,0.3320610687022901
골드 1,포함 배제의 원리,97,32,65,0.32989690721649484
골드 1,머지 소트 트리,40,13,27,0.325
골드 1,다차원 세그먼트 트리,28,9,19,0.32142857142857145
골드 1,다각형의 넓이,576,182,394,0.3159722222222222
골드 1,2-sat,48,15,33,0.3125
골드 1,수치해석,194,60,134,0.30927835051546393
골드 1,벨만–포드,1999,616,1383,0.30815407703851927
골드 1,오일러 경로 테크닉,13,4,9,0.3076923076923077
골드 1,덱을 이용한 다이나믹 프로그래밍,26,8,18,0.3076923076923077
골드 1,아호-코라식,36,11,25,0.3055555555555556
골드 1,선분 교차 판정,765,229,536,0.29934640522875816
골드 1,가우스 소거법,35,10,25,0.2857142857142857
골드 1,제곱근 분할법,55,15,40,0.2727272727272727
골드 1,라빈–카프,69,18,51,0.2608695652173913
골드 1,접미사 배열과 lcp 배열,99,25,74,0.25252525252525254
골드 1,오프라인 쿼리,198,50,148,0.25252525252525254
골드 1,이분 그래프,4,1,3,0.25
골드 1,센트로이드 분할,17,4,13,0.23529411764705882
골드 1,센트로이드,17,4,13,0.23529411764705882
골드 1,고속 푸리에 변환,47,10,37,0.2127659574468085
골드 1,물리학,52,11,41,0.21153846153846154
골드 1,해싱,107,22,85,0.205607476635514
골드 1,로프,11,2,9,0.18181818181818182
골드 1,양방향 탐색,29,5,24,0.1724137931034483
골드 1,heavy-light 분할,12,2,10,0.16666666666666666
골드 1,오일러 경로,130,21,109,0.16153846153846155
골드 1,최대 유량 최소 컷 정리,26,3,23,0.11538461538461539
골드 1,분할 정복을 사용한 최적화,19,2,17,0.10526315789473684
골드 1,크누스 최적화,15,1,14,0.06666666666666667
골드 1,aliens 트릭,2,0,2,0.0
골드 1,🌎👨‍💻📄🎱📖🧪,6,0,6,0.0
골드 1,🧑‍💻,6,0,6,0.0
골드 1,🏃🤔,6,0,6,0.0
골드 1,보로노이 다이어그램,3,0,3,0.0
골드 1,히르쉬버그,1,0,1,0.0
골드 1,🧵,6,0,6,0.0
골드 1,춤추는 링크,2,0,2,0.0
골드 1,오프라인 동적 연결성 판정,6,0,6,0.0
골드 1,크누스 x,2,0,2,0.0
골드 1,뫼비우스 반전 공식,7,0,7,0.0
골드 2,선인장,1,1,0,1.0
골드 2,함수 개형을 이용한 최적화,1,1,0,1.0
골드 2,로프,3,3,0,1.0
골드 2,2-sat,9,9,0,1.0
골드 2,오목 다각형 내부의 점 판정,1,1,0,1.0
골드 2,번사이드 보조정리,1,1,0,1.0
골드 2,최소 비용 최대 유량,6,6,0,1.0
골드 2,접미사 트리,1,1,0,1.0
골드 2,쌍대성,1,1,0,1.0
골드 2,z,4,3,1,0.75
골드 2,사칙연산,17032,12665,4367,0.7436002818224519
골드 2,폴라드 로,23,16,7,0.6956521739130435
골드 2,순열 사이클 분할,118,79,39,0.6694915254237288
골드 2,볼록 껍질을 이용한 최적화,9,6,3,0.6666666666666666
골드 2,큐,3814,2461,1353,0.645254326166754
골드 2,피타고라스 정리,743,461,282,0.620457604306864
골드 2,구현,72615,43888,28727,0.6043930317427528
골드 2,재귀,7924,4774,3150,0.6024734982332155
골드 2,가우스 소거법,5,3,2,0.6
골드 2,수학,60080,35487,24593,0.5906624500665779
골드 2,삼분 탐색,53,31,22,0.5849056603773585
골드 2,문자열,21755,12511,9244,0.5750861870834291
골드 2,유클리드 호제법,2113,1210,903,0.5726455276857548
골드 2,큰 수 연산,2827,1592,1235,0.5631411390166254
골드 2,임의 정밀도,2827,1592,1235,0.5631411390166254
골드 2,플로이드–와샬,3411,1910,1501,0.5599530929346233
골드 2,조합론,5256,2943,2313,0.559931506849315
골드 2,오일러 지표 (χ=v-e+f),77,43,34,0.5584415584415584
골드 2,백트래킹,20175,11105,9070,0.5504337050805452
골드 2,단절점과 단절선,40,22,18,0.55
골드 2,해시를 사용한 집합과 맵,5008,2712,2296,0.5415335463258786
골드 2,게임 이론,929,503,426,0.5414424111948332
골드 2,좌표 압축,874,469,405,0.5366132723112128
골드 2,값,874,469,405,0.5366132723112128
골드 2,위상 정렬,1840,979,861,0.5320652173913043
골드 2,시뮬레이션,17727,9399,8328,0.5302081570485699
골드 2,분할 정복,5307,2780,2527,0.5238364424345204
골드 2,최소 스패닝 트리,2341,1213,1128,0.5181546347714652
골드 2,오일러 피 함수,56,29,27,0.5178571428571429
골드 2,브루트포스 알고리즘,33927,17167,16760,0.505998172546939
골드 2,연결 리스트,824,416,408,0.5048543689320388
골드 2,다이나믹 프로그래밍,44364,22204,22160,0.50049589757461
골드 2,정렬,27264,13638,13626,0.5002200704225352
골드 2,희소 배열,186,93,93,0.5
골드 2,분할 정복을 사용한 최적화,12,6,6,0.5
골드 2,정규 표현식,308,152,156,0.4935064935064935
골드 2,스택,10205,5029,5176,0.49279764821166094
골드 2,그리디 알고리즘,21288,10445,10843,0.49065201052236
골드 2,트리,6773,3305,3468,0.4879669275062749
골드 2,덱,3096,1510,1586,0.4877260981912145
골드 2,정수론,12005,5824,6181,0.485131195335277
골드 2,깊이 우선 탐색,23404,11317,12087,0.4835498205434968
골드 2,선형대수학,722,349,373,0.48337950138504154
골드 2,트리에서의 다이나믹 프로그래밍,418,202,216,0.48325358851674644
골드 2,파싱,3041,1461,1580,0.4804340677408747
골드 2,기하학,5028,2406,2622,0.4785202863961814
골드 2,3차원 기하학,84,40,44,0.47619047619047616
골드 2,소수 판정,5679,2699,2980,0.47525972882549744
골드 2,밀러–라빈 소수 판별법,40,19,21,0.475
골드 2,자료 구조,39411,18703,20708,0.4745629392809114
골드 2,배낭 문제,2599,1224,1375,0.470950365525202
골드 2,에라토스테네스의 체,4514,2123,2391,0.47031457687195394
골드 2,너비 우선 탐색,44777,20843,23934,0.46548451213792796
골드 2,최소 공통 조상,375,174,201,0.464
골드 2,그래프 탐색,56261,25756,30505,0.4577949201045129
골드 2,그래프 이론,72798,32892,39906,0.45182559960438473
골드 2,누적 합,4498,2012,2486,0.447309915518008
골드 2,포함 배제의 원리,47,21,26,0.44680851063829785
골드 2,확률론,130,58,72,0.4461538461538462
골드 2,가장 긴 증가하는 부분 수열: o(n log n),1417,624,793,0.44036697247706424
골드 2,확장 유클리드 호제법,44,19,25,0.4318181818181818
골드 2,트라이,456,196,260,0.4298245614035088
골드 2,제곱근 분할법,7,3,4,0.42857142857142855
골드 2,최대 유량,80,34,46,0.425
골드 2,모듈로 곱셈 역원,422,179,243,0.42417061611374407
골드 2,이분 매칭,189,80,109,0.42328042328042326
골드 2,우선순위 큐,7991,3382,4609,0.42322612939557
골드 2,슬라이딩 윈도우,1612,682,930,0.4230769230769231
골드 2,비트마스킹,3809,1589,2220,0.41716986085586766
골드 2,머지 소트 트리,12,5,7,0.4166666666666667
골드 2,물리학,53,22,31,0.41509433962264153
골드 2,페르마의 소정리,405,167,238,0.4123456790123457
골드 2,기댓값의 선형성,22,9,13,0.4090909090909091
골드 2,kmp,513,209,304,0.4074074074074074
골드 2,미적분학,84,34,50,0.40476190476190477
골드 2,오프라인 쿼리,42,17,25,0.40476190476190477
골드 2,외판원 순회 문제,1001,405,596,0.4045954045954046
골드 2,두 포인터,7812,3098,4714,0.3965693804403482
골드 2,분할 정복을 이용한 거듭제곱,2915,1148,1767,0.39382504288164666
골드 2,분리 집합,3556,1390,2166,0.390888638920135
골드 2,비트필드를 이용한 다이나믹 프로그래밍,517,201,316,0.38878143133462284
골드 2,다익스트라,11073,4277,6796,0.3862548541497336
골드 2,애드 혹,1279,494,785,0.3862392494136044
골드 2,이분 탐색,16072,6117,9955,0.3805998008959681
골드 2,고속 푸리에 변환,66,25,41,0.3787878787878788
골드 2,런타임 전의 전처리,246,93,153,0.3780487804878049
골드 2,트리를 사용한 집합과 맵,2155,814,1341,0.3777262180974478
골드 2,heavy-light 분할,8,3,5,0.375
골드 2,강한 연결 요소,104,39,65,0.375
골드 2,0-1 너비 우선 탐색,2012,751,1261,0.37326043737574555
골드 2,구성적,627,232,395,0.3700159489633174
골드 2,작은 집합에서 큰 집합으로 합치는 테크닉,11,4,7,0.36363636363636365
골드 2,mo's,14,5,9,0.35714285714285715
골드 2,많은 조건 분기,2154,758,1396,0.3519034354688951
골드 2,매개 변수 탐색,6212,2175,4037,0.35012878300064393
골드 2,덱을 이용한 다이나믹 프로그래밍,20,7,13,0.35
골드 2,세그먼트 트리,2464,841,1623,0.34131493506493504
골드 2,중국인의 나머지 정리,740,251,489,0.33918918918918917
골드 2,매내처,9,3,6,0.3333333333333333
골드 2,평면 그래프,3,1,2,0.3333333333333333
골드 2,스위핑,1058,350,708,0.33081285444234404
골드 2,다각형의 넓이,271,89,182,0.3284132841328413
골드 2,비둘기집 원리,67,22,45,0.3283582089552239
골드 2,중간에서 만나기,661,217,444,0.32829046898638425
골드 2,접미사 배열과 lcp 배열,38,12,26,0.3157894736842105
골드 2,볼록 껍질,135,42,93,0.3111111111111111
골드 2,벨만–포드,1273,383,890,0.30086410054988216
골드 2,느리게 갱신되는 세그먼트 트리,164,48,116,0.2926829268292683
골드 2,오일러 경로 테크닉,7,2,5,0.2857142857142857
골드 2,회전하는 캘리퍼스,7,2,5,0.2857142857142857
골드 2,스프라그–그런디 정리,46,13,33,0.2826086956521739
골드 2,볼록 다각형 내부의 점 판정,18,5,13,0.2777777777777778
골드 2,비트 집합,51,14,37,0.27450980392156865
골드 2,병렬 이분 탐색,4,1,3,0.25
골드 2,스플레이 트리,8,2,6,0.25
골드 2,뫼비우스 반전 공식,4,1,3,0.25
골드 2,선분 교차 판정,413,101,312,0.24455205811138014
골드 2,뤼카 정리,56,13,43,0.23214285714285715
골드 2,라빈–카프,31,7,24,0.22580645161290322
골드 2,무작위화,10,2,8,0.2
골드 2,센트로이드,12,2,10,0.16666666666666666
골드 2,퍼시스턴트 세그먼트 트리,6,1,5,0.16666666666666666
골드 2,수치해석,43,7,36,0.16279069767441862
골드 2,다차원 세그먼트 트리,31,5,26,0.16129032258064516
골드 2,해싱,76,12,64,0.15789473684210525
골드 2,최대 유량 최소 컷 정리,13,2,11,0.15384615384615385
골드 2,아호-코라식,27,4,23,0.14814814814814814
골드 2,오일러 경로,27,4,23,0.14814814814814814
골드 2,벌래캠프–매시,8,1,7,0.125
골드 2,🌎👨‍💻📄🎱📖🧪,13,0,13,0.0
골드 2,🧵,13,0,13,0.0
골드 2,🧑‍💻,13,0,13,0.0
골드 2,휴리스틱,10,0,10,0.0
골드 2,최소 외접원,2,0,2,0.0
골드 2,통계학,1,0,1,0.0
골드 2,히르쉬버그,2,0,2,0.0
골드 2,a*,1,0,1,0.0
골드 2,🏃🤔,13,0,13,0.0
골드 3,최대 유량 최소 컷 정리,2,2,0,1.0
골드 3,z,1,1,0,1.0
골드 3,오일러 경로 테크닉,3,3,0,1.0
골드 3,오프라인 동적 연결성 판정,1,1,0,1.0
골드 3,매트로이드,1,1,0,1.0
골드 3,보로노이 다이어그램,35,33,2,0.9428571428571428
골드 3,2-sat,7,6,1,0.8571428571428571
골드 3,벌래캠프–매시,4,3,1,0.75
골드 3,오일러 지표 (χ=v-e+f),65,48,17,0.7384615384615385
골드 3,순열 사이클 분할,133,98,35,0.7368421052631579
골드 3,사칙연산,23110,17008,6102,0.7359584595413241
골드 3,비트 집합,7,5,2,0.7142857142857143
골드 3,heavy-light 분할,7,5,2,0.7142857142857143
골드 3,기댓값의 선형성,13,9,4,0.6923076923076923
골드 3,피타고라스 정리,934,633,301,0.6777301927194861
골드 3,3차원 기하학,67,45,22,0.6716417910447762
골드 3,선인장,3,2,1,0.6666666666666666
골드 3,삼분 탐색,41,27,14,0.6585365853658537
골드 3,확률론,118,76,42,0.6440677966101694
골드 3,큐,5157,3252,1905,0.6305991855730075
골드 3,휴리스틱,8,5,3,0.625
골드 3,구현,86089,53542,32547,0.6219377620834253
골드 3,재귀,8550,5315,3235,0.6216374269005848
골드 3,수학,77238,45747,31491,0.5922861803775343
골드 3,큰 수 연산,3381,1957,1424,0.5788228334812185
골드 3,임의 정밀도,3381,1957,1424,0.5788228334812185
골드 3,문자열,29842,17213,12629,0.5768045037195898
골드 3,조합론,5937,3423,2514,0.5765538150581102
골드 3,게임 이론,744,427,317,0.5739247311827957
골드 3,백트래킹,19790,11357,8433,0.5738756947953512
골드 3,기하학,5398,3057,2341,0.5663208595776213
골드 3,플로이드–와샬,2761,1562,1199,0.5657370517928287
골드 3,최소 스패닝 트리,1693,941,752,0.5558180744240993
골드 3,분할 정복,5463,3029,2434,0.5544572579168955
골드 3,런타임 전의 전처리,258,143,115,0.5542635658914729
골드 3,유클리드 호제법,3177,1719,1458,0.5410764872521246
골드 3,시뮬레이션,15937,8579,7358,0.5383070841438162
골드 3,위상 정렬,1176,630,546,0.5357142857142857
골드 3,해시를 사용한 집합과 맵,6126,3241,2885,0.5290564805746001
골드 3,브루트포스 알고리즘,36500,18791,17709,0.5148219178082192
골드 3,선형대수학,649,334,315,0.514637904468413
골드 3,포함 배제의 원리,39,20,19,0.5128205128205128
골드 3,좌표 압축,1122,575,547,0.5124777183600713
골드 3,값,1122,575,547,0.5124777183600713
골드 3,다이나믹 프로그래밍,45276,22908,22368,0.5059634243307712
골드 3,깊이 우선 탐색,24616,12387,12229,0.5032092947676308
골드 3,병렬 이분 탐색,2,1,1,0.5
골드 3,양방향 탐색,6,3,3,0.5
골드 3,스프라그–그런디 정리,44,22,22,0.5
골드 3,평면 그래프,2,1,1,0.5
골드 3,최소 비용 최대 유량,4,2,2,0.5
골드 3,선형 계획법,4,2,2,0.5
골드 3,퍼시스턴트 세그먼트 트리,2,1,1,0.5
골드 3,폴라드 로,26,13,13,0.5
골드 3,헝가리안,4,2,2,0.5
골드 3,정렬,33719,16781,16938,0.49767193570390583
골드 3,스택,12930,6393,6537,0.49443155452436194
골드 3,그리디 알고리즘,23586,11629,11957,0.4930467226320699
골드 3,트리,5923,2864,3059,0.4835387472564579
골드 3,자료 구조,45212,21796,23416,0.48208440237105193
골드 3,너비 우선 탐색,44792,21531,23261,0.480688515806394
골드 3,물리학,25,12,13,0.48
골드 3,정수론,15731,7536,8195,0.4790540970059119
골드 3,그래프 탐색,54766,25677,29089,0.46884928605339077
골드 3,강한 연결 요소,60,28,32,0.4666666666666667
골드 3,그래프 이론,67589,31351,36238,0.46384766751986267
골드 3,덱,3905,1808,2097,0.46299615877080663
골드 3,소수 판정,7720,3551,4169,0.4599740932642487
골드 3,배낭 문제,2313,1053,1260,0.45525291828793774
골드 3,mo's,20,9,11,0.45
골드 3,에라토스테네스의 체,6153,2757,3396,0.44807411019015114
골드 3,파싱,4253,1905,2348,0.4479191159181754
골드 3,연결 리스트,1184,527,657,0.44510135135135137
골드 3,이분 매칭,126,56,70,0.4444444444444444
골드 3,가장 긴 증가하는 부분 수열: o(n log n),1030,457,573,0.4436893203883495
골드 3,우선순위 큐,8139,3583,4556,0.4402260719990171
골드 3,오일러 피 함수,65,28,37,0.4307692307692308
골드 3,누적 합,4686,1963,2723,0.4189073836961161
골드 3,최소 외접원,12,5,7,0.4166666666666667
골드 3,모듈로 곱셈 역원,355,146,209,0.4112676056338028
골드 3,비트마스킹,3201,1316,1885,0.41112152452358636
골드 3,두 포인터,7108,2917,4191,0.4103826674169949
골드 3,느리게 갱신되는 세그먼트 트리,93,38,55,0.40860215053763443
골드 3,트리에서의 다이나믹 프로그래밍,357,145,212,0.4061624649859944
골드 3,정규 표현식,531,214,317,0.4030131826741996
골드 3,뤼카 정리,10,4,6,0.4
골드 3,다익스트라,9150,3645,5505,0.3983606557377049
골드 3,슬라이딩 윈도우,1488,591,897,0.3971774193548387
골드 3,최대 유량,63,25,38,0.3968253968253968
골드 3,최소 공통 조상,335,132,203,0.3940298507462687
골드 3,구성적,561,220,341,0.39215686274509803
골드 3,확장 유클리드 호제법,23,9,14,0.391304347826087
골드 3,분리 집합,2547,996,1551,0.3910482921083628
골드 3,이분 탐색,18097,6978,11119,0.3855887716196055
골드 3,아호-코라식,26,10,16,0.38461538461538464
골드 3,회전하는 캘리퍼스,26,10,16,0.38461538461538464
골드 3,다각형의 넓이,195,75,120,0.38461538461538464
골드 3,트라이,541,208,333,0.3844731977818854
골드 3,트리를 사용한 집합과 맵,2663,1010,1653,0.3792714983101765
골드 3,분할 정복을 이용한 거듭제곱,2681,1016,1665,0.37896307348004477
골드 3,단절점과 단절선,53,20,33,0.37735849056603776
골드 3,볼록 껍질을 이용한 최적화,8,3,5,0.375
골드 3,0-1 너비 우선 탐색,1430,531,899,0.3713286713286713
골드 3,비트필드를 이용한 다이나믹 프로그래밍,284,105,179,0.36971830985915494
골드 3,희소 배열,226,83,143,0.3672566371681416
골드 3,페르마의 소정리,387,142,245,0.3669250645994832
골드 3,외판원 순회 문제,738,270,468,0.36585365853658536
골드 3,볼록 껍질,107,39,68,0.3644859813084112
골드 3,스위핑,707,256,451,0.3620933521923621
골드 3,애드 혹,1505,542,963,0.3601328903654485
골드 3,kmp,490,174,316,0.3551020408163265
골드 3,매개 변수 탐색,7656,2711,4945,0.35410135841170326
골드 3,많은 조건 분기,2241,767,1474,0.3422579205711736
골드 3,세그먼트 트리,1979,661,1318,0.33400707427993936
골드 3,덱을 이용한 다이나믹 프로그래밍,6,2,4,0.3333333333333333
골드 3,볼록 다각형 내부의 점 판정,3,1,2,0.3333333333333333
골드 3,함수 개형을 이용한 최적화,6,2,4,0.3333333333333333
골드 3,밀러–라빈 소수 판별법,51,17,34,0.3333333333333333
골드 3,중간에서 만나기,538,175,363,0.3252788104089219
골드 3,중국인의 나머지 정리,718,226,492,0.3147632311977716
골드 3,벨만–포드,862,254,608,0.29466357308584684
골드 3,미적분학,72,20,52,0.2777777777777778
골드 3,오프라인 쿼리,86,23,63,0.26744186046511625
골드 3,선분 교차 판정,266,71,195,0.2669172932330827
골드 3,비둘기집 원리,120,32,88,0.26666666666666666
골드 3,수치해석,49,13,36,0.2653061224489796
골드 3,매내처,28,7,21,0.25
골드 3,무작위화,24,4,20,0.16666666666666666
골드 3,머지 소트 트리,30,5,25,0.16666666666666666
골드 3,작은 집합에서 큰 집합으로 합치는 테크닉,6,1,5,0.16666666666666666
골드 3,오일러 경로,27,4,23,0.14814814814814814
골드 3,고속 푸리에 변환,34,5,29,0.14705882352941177
골드 3,라빈–카프,35,4,31,0.11428571428571428
골드 3,접미사 배열과 lcp 배열,35,4,31,0.11428571428571428
골드 3,제곱근 분할법,18,2,16,0.1111111111111111
골드 3,다차원 세그먼트 트리,11,1,10,0.09090909090909091
골드 3,해싱,113,9,104,0.07964601769911504
골드 3,utf-8 입력 처리,1,0,1,0.0
골드 3,a*,13,0,13,0.0
골드 3,이중 연결 요소,1,0,1,0.0
골드 3,크누스 최적화,2,0,2,0.0
골드 3,크누스 x,1,0,1,0.0
골드 3,춤추는 링크,1,0,1,0.0
골드 3,🧵,7,0,7,0.0
골드 3,🌎👨‍💻📄🎱📖🧪,7,0,7,0.0
골드 3,회문 트리,1,0,1,0.0
골드 3,🧑‍💻,7,0,7,0.0
골드 3,aliens 트릭,1,0,1,0.0
골드 3,🏃🤔,7,0,7,0.0
골드 4,오일러 경로,2,2,0,1.0
골드 4,최소 비용 최대 유량,1,1,0,1.0
골드 4,볼록 다각형 내부의 점 판정,1,1,0,1.0
골드 4,기댓값의 선형성,5,5,0,1.0
골드 4,담금질 기법,1,1,0,1.0
골드 4,단절점과 단절선,12,11,1,0.9166666666666666
골드 4,순열 사이클 분할,114,87,27,0.7631578947368421
골드 4,사칙연산,25691,18567,7124,0.7227044490288428
골드 4,오일러 지표 (χ=v-e+f),60,43,17,0.7166666666666667
골드 4,피타고라스 정리,1003,628,375,0.6261216350947159
골드 4,구현,85068,52747,32321,0.6200568956599426
골드 4,큐,5671,3458,2213,0.6097690001763357
골드 4,수학,80208,47304,32904,0.5897666068222621
골드 4,재귀,7860,4534,3326,0.5768447837150127
골드 4,백트래킹,16194,9253,6941,0.5713844633814993
골드 4,문자열,29698,16779,12919,0.564987541248569
골드 4,플로이드–와샬,1933,1085,848,0.5613036730470771
골드 4,유클리드 호제법,3223,1801,1422,0.5587961526528079
골드 4,분할 정복,4652,2597,2055,0.5582545141874462
골드 4,3차원 기하학,49,27,22,0.5510204081632653
골드 4,조합론,5277,2881,2396,0.5459541406101952
골드 4,확률론,70,38,32,0.5428571428571428
골드 4,기하학,5247,2840,2407,0.541261673337145
골드 4,임의 정밀도,3768,2016,1752,0.535031847133758
골드 4,큰 수 연산,3768,2016,1752,0.535031847133758
골드 4,선형대수학,567,301,266,0.5308641975308642
골드 4,게임 이론,644,338,306,0.5248447204968945
골드 4,위상 정렬,796,413,383,0.5188442211055276
골드 4,희소 배열,62,32,30,0.5161290322580645
골드 4,시뮬레이션,11970,6105,5865,0.5100250626566416
골드 4,최소 스패닝 트리,1153,583,570,0.5056374674761491
골드 4,브루트포스 알고리즘,32016,16081,15935,0.5022801099450275
골드 4,해시를 사용한 집합과 맵,5664,2841,2823,0.5015889830508474
골드 4,가우스 소거법,2,1,1,0.5
골드 4,삼분 탐색,22,11,11,0.5
골드 4,접미사 트리,2,1,1,0.5
골드 4,최소 공통 조상,158,79,79,0.5
골드 4,매트로이드,2,1,1,0.5
골드 4,비트 집합,10,5,5,0.5
골드 4,깊이 우선 탐색,19350,9644,9706,0.4983979328165375
골드 4,스택,12591,6269,6322,0.4978953220554364
골드 4,그리디 알고리즘,22096,10941,11155,0.4951574945691528
골드 4,정렬,31795,15721,16074,0.4944488127064004
골드 4,다이나믹 프로그래밍,40227,19777,20450,0.4916349715365302
골드 4,런타임 전의 전처리,242,118,124,0.48760330578512395
골드 4,오일러 피 함수,35,17,18,0.4857142857142857
골드 4,트리,3778,1833,1945,0.48517734250926414
골드 4,정수론,15929,7595,8334,0.47680331470902126
골드 4,자료 구조,41102,19588,21514,0.476570483188166
골드 4,너비 우선 탐색,34940,16551,18389,0.47369776760160276
골드 4,좌표 압축,1151,541,610,0.47002606429192006
골드 4,값,1151,541,610,0.47002606429192006
골드 4,그래프 탐색,41228,19157,22071,0.4646599398467061
골드 4,강한 연결 요소,41,19,22,0.4634146341463415
골드 4,그래프 이론,49257,22532,26725,0.4574375215705382
골드 4,소수 판정,7803,3548,4255,0.4546969114443163
골드 4,미적분학,38,17,21,0.4473684210526316
골드 4,덱,3728,1664,2064,0.44635193133047213
골드 4,에라토스테네스의 체,6049,2677,3372,0.4425524880145479
골드 4,트라이,319,139,180,0.43573667711598746
골드 4,파싱,3953,1709,2244,0.43232987604351125
골드 4,가장 긴 증가하는 부분 수열: o(n log n),767,327,440,0.42633637548891784
골드 4,연결 리스트,1237,524,713,0.423605497170574
골드 4,배낭 문제,1587,672,915,0.42344045368620037
골드 4,우선순위 큐,6495,2739,3756,0.42170900692840646
골드 4,비트마스킹,2786,1166,1620,0.41852117731514715
골드 4,구성적,399,165,234,0.41353383458646614
골드 4,두 포인터,4900,1964,2936,0.4008163265306122
골드 4,모듈로 곱셈 역원,322,126,196,0.391304347826087
골드 4,누적 합,3964,1543,2421,0.38925327951564076
골드 4,페르마의 소정리,301,116,185,0.3853820598006645
골드 4,트리에서의 다이나믹 프로그래밍,217,83,134,0.3824884792626728
골드 4,정규 표현식,448,171,277,0.38169642857142855
골드 4,애드 혹,1205,455,750,0.3775933609958506
골드 4,트리를 사용한 집합과 맵,1839,694,1145,0.377379010331702
골드 4,슬라이딩 윈도우,1273,479,794,0.3762765121759623
골드 4,다익스트라,5578,2069,3509,0.37092147723198277
골드 4,접미사 배열과 lcp 배열,19,7,12,0.3684210526315789
골드 4,비트필드를 이용한 다이나믹 프로그래밍,199,73,126,0.36683417085427134
골드 4,분리 집합,1751,632,1119,0.36093660765276986
골드 4,이분 탐색,15213,5470,9743,0.3595609018602511
골드 4,비둘기집 원리,70,25,45,0.35714285714285715
골드 4,이분 매칭,130,46,84,0.35384615384615387
골드 4,볼록 껍질,71,25,46,0.352112676056338
골드 4,최대 유량 최소 컷 정리,20,7,13,0.35
골드 4,느리게 갱신되는 세그먼트 트리,20,7,13,0.35
골드 4,확장 유클리드 호제법,43,15,28,0.3488372093023256
골드 4,0-1 너비 우선 탐색,928,315,613,0.3394396551724138
골드 4,분할 정복을 이용한 거듭제곱,2394,811,1583,0.3387635756056809
골드 4,외판원 순회 문제,596,201,395,0.337248322147651
골드 4,많은 조건 분기,1921,643,1278,0.33472149921915667
골드 4,평면 그래프,3,1,2,0.3333333333333333
골드 4,쌍대 그래프,3,1,2,0.3333333333333333
골드 4,매개 변수 탐색,6598,2177,4421,0.32994846923310095
골드 4,중국인의 나머지 정리,706,220,486,0.311614730878187
골드 4,세그먼트 트리,1264,390,874,0.30854430379746833
골드 4,kmp,399,120,279,0.3007518796992481
골드 4,퍼시스턴트 세그먼트 트리,10,3,7,0.3
골드 4,중간에서 만나기,298,89,209,0.2986577181208054
골드 4,스위핑,695,204,491,0.2935251798561151
골드 4,최대 유량,75,22,53,0.29333333333333333
골드 4,아호-코라식,14,4,10,0.2857142857142857
골드 4,고속 푸리에 변환,21,6,15,0.2857142857142857
골드 4,함수 개형을 이용한 최적화,7,2,5,0.2857142857142857
골드 4,매내처,25,7,18,0.28
골드 4,포함 배제의 원리,43,12,31,0.27906976744186046
골드 4,벨만–포드,678,178,500,0.26253687315634217
골드 4,수치해석,46,12,34,0.2608695652173913
골드 4,스프라그–그런디 정리,77,20,57,0.2597402597402597
골드 4,다각형의 넓이,166,42,124,0.25301204819277107
골드 4,다차원 세그먼트 트리,16,4,12,0.25
골드 4,오일러 경로 테크닉,4,1,3,0.25
골드 4,밀러–라빈 소수 판별법,160,40,120,0.25
골드 4,heavy-light 분할,4,1,3,0.25
골드 4,폴라드 로,154,37,117,0.24025974025974026
골드 4,뤼카 정리,47,11,36,0.23404255319148937
골드 4,작은 집합에서 큰 집합으로 합치는 테크닉,18,4,14,0.2222222222222222
골드 4,선분 교차 판정,191,40,151,0.2094240837696335
골드 4,오프라인 쿼리,30,6,24,0.2
골드 4,분할 정복을 사용한 최적화,17,3,14,0.17647058823529413
골드 4,물리학,19,3,16,0.15789473684210525
골드 4,머지 소트 트리,19,3,16,0.15789473684210525
골드 4,휴리스틱,13,2,11,0.15384615384615385
골드 4,회전하는 캘리퍼스,13,2,11,0.15384615384615385
골드 4,무작위화,35,5,30,0.14285714285714285
골드 4,오프라인 동적 연결성 판정,8,1,7,0.125
골드 4,라빈–카프,10,1,9,0.1
골드 4,mo's,12,1,11,0.08333333333333333
골드 4,병렬 이분 탐색,30,2,28,0.06666666666666667
골드 4,해싱,59,2,57,0.03389830508474576
골드 4,일반적인 매칭,6,0,6,0.0
골드 4,볼록 껍질을 이용한 최적화,1,0,1,0.0
골드 4,히르쉬버그,1,0,1,0.0
골드 4,🏃🤔,9,0,9,0.0
골드 4,🧑‍💻,9,0,9,0.0
골드 4,스플레이 트리,2,0,2,0.0
골드 4,🧵,9,0,9,0.0
골드 4,춤추는 링크,2,0,2,0.0
골드 4,제곱근 분할법,2,0,2,0.0
골드 4,키타마사,1,0,1,0.0
골드 4,상수 최적화,1,0,1,0.0
골드 4,크누스 x,2,0,2,0.0
골드 4,🌎👨‍💻📄🎱📖🧪,9,0,9,0.0
골드 4,크누스 최적화,1,0,1,0.0
골드 4,로프,1,0,1,0.0
골드 4,최소 외접원,1,0,1,0.0
골드 5,춤추는 링크,3,3,0,1.0
골드 5,크누스 x,3,3,0,1.0
골드 5,제곱근 분할법,1,1,0,1.0
골드 5,함수 개형을 이용한 최적화,4,4,0,1.0
골드 5,센트로이드 분할,1,1,0,1.0
골드 5,단조 큐를 이용한 최적화,2,2,0,1.0
골드 5,센트로이드,1,1,0,1.0
골드 5,오일러 지표 (χ=v-e+f),53,50,3,0.9433962264150944
골드 5,삼분 탐색,4,3,1,0.75
골드 5,사칙연산,35270,25427,9843,0.7209242982704849
골드 5,폴라드 로,24,17,7,0.7083333333333334
골드 5,분할 정복을 사용한 최적화,3,2,1,0.6666666666666666
골드 5,강한 연결 요소,17,11,6,0.6470588235294118
골드 5,구현,98486,63547,34939,0.6452389172065065
골드 5,순열 사이클 분할,76,48,28,0.631578947368421
골드 5,피타고라스 정리,1449,909,540,0.6273291925465838
골드 5,큐,6506,3965,2541,0.6094374423608976
골드 5,수학,98717,59545,39172,0.6031889137635869
골드 5,조합론,4639,2751,1888,0.5930157361500323
골드 5,문자열,33614,19900,13714,0.5920152317486761
골드 5,재귀,6495,3824,2671,0.5887605850654349
골드 5,기하학,6504,3744,2760,0.5756457564575646
골드 5,게임 이론,669,382,287,0.5710014947683109
골드 5,백트래킹,12242,6979,5263,0.570086587158961
골드 5,최소 스패닝 트리,780,435,345,0.5576923076923077
골드 5,플로이드–와샬,1179,657,522,0.5572519083969466
골드 5,큰 수 연산,4152,2306,1846,0.5553949903660886
골드 5,임의 정밀도,4152,2306,1846,0.5553949903660886
골드 5,분할 정복,3580,1974,1606,0.5513966480446927
골드 5,유클리드 호제법,4437,2369,2068,0.5339193148523778
골드 5,시뮬레이션,9881,5097,4784,0.5158384778868536
골드 5,브루트포스 알고리즘,29608,15109,14499,0.5103012699270467
골드 5,해시를 사용한 집합과 맵,5039,2559,2480,0.5078388569160548
골드 5,머지 소트 트리,10,5,5,0.5
골드 5,스택,14163,7077,7086,0.49968227070535903
골드 5,그리디 알고리즘,21034,10487,10547,0.49857373775791575
골드 5,깊이 우선 탐색,14887,7410,7477,0.4977497145160207
골드 5,다이나믹 프로그래밍,35006,17276,17730,0.49351539736045247
골드 5,정렬,34834,17126,17708,0.4916460928977436
골드 5,파싱,3869,1897,1972,0.4903075730162833
골드 5,자료 구조,40386,19667,20719,0.4869756846431932
골드 5,정수론,19653,9425,10228,0.47957054902559404
골드 5,트리,2923,1401,1522,0.4793020868970236
골드 5,덱,3577,1703,1874,0.4760972882303606
골드 5,선형대수학,364,173,191,0.47527472527472525
골드 5,너비 우선 탐색,26460,12344,14116,0.46651549508692364
골드 5,소수 판정,10675,4839,5836,0.45330210772833723
골드 5,그래프 탐색,31081,14081,17000,0.4530420514140472
골드 5,위상 정렬,597,270,327,0.45226130653266333
골드 5,그래프 이론,36689,16451,20238,0.44839052577066696
골드 5,런타임 전의 전처리,279,125,154,0.44802867383512546
골드 5,좌표 압축,1273,562,711,0.44147682639434405
골드 5,값,1273,562,711,0.44147682639434405
골드 5,비둘기집 원리,57,25,32,0.43859649122807015
골드 5,에라토스테네스의 체,8340,3648,4692,0.437410071942446
골드 5,최소 공통 조상,173,75,98,0.43352601156069365
골드 5,우선순위 큐,4802,2065,2737,0.43002915451895046
골드 5,kmp,284,122,162,0.4295774647887324
골드 5,뤼카 정리,21,9,12,0.42857142857142855
골드 5,연결 리스트,1436,611,825,0.4254874651810585
골드 5,배낭 문제,1377,584,793,0.4241103848946986
골드 5,구성적,408,173,235,0.42401960784313725
골드 5,정규 표현식,323,136,187,0.42105263157894735
골드 5,트리를 사용한 집합과 맵,1242,522,720,0.42028985507246375
골드 5,오일러 경로 테크닉,12,5,7,0.4166666666666667
골드 5,미적분학,46,19,27,0.41304347826086957
골드 5,확률론,114,47,67,0.41228070175438597
골드 5,모듈로 곱셈 역원,213,87,126,0.4084507042253521
골드 5,비트마스킹,2311,940,1371,0.4067503245348334
골드 5,최소 비용 최대 유량,5,2,3,0.4
골드 5,heavy-light 분할,5,2,3,0.4
골드 5,오일러 경로,5,2,3,0.4
골드 5,비트 집합,23,9,14,0.391304347826087
골드 5,애드 혹,1077,418,659,0.3881151346332405
골드 5,가장 긴 증가하는 부분 수열: o(n log n),480,186,294,0.3875
골드 5,페르마의 소정리,203,77,126,0.3793103448275862
골드 5,두 포인터,4070,1501,2569,0.3687960687960688
골드 5,오프라인 쿼리,19,7,12,0.3684210526315789
골드 5,다각형의 넓이,101,37,64,0.36633663366336633
골드 5,트라이,243,89,154,0.3662551440329218
골드 5,누적 합,3092,1130,1962,0.3654592496765847
골드 5,많은 조건 분기,1841,672,1169,0.3650190114068441
골드 5,수치해석,11,4,7,0.36363636363636365
골드 5,매내처,11,4,7,0.36363636363636365
골드 5,이분 매칭,99,36,63,0.36363636363636365
골드 5,3차원 기하학,53,19,34,0.3584905660377358
골드 5,볼록 껍질,28,10,18,0.35714285714285715
골드 5,다익스트라,4227,1492,2735,0.3529690087532529
골드 5,포함 배제의 원리,43,15,28,0.3488372093023256
골드 5,밀러–라빈 소수 판별법,72,25,47,0.3472222222222222
골드 5,슬라이딩 윈도우,848,288,560,0.33962264150943394
골드 5,이분 탐색,13285,4501,8784,0.33880316146029354
골드 5,분리 집합,1206,408,798,0.3383084577114428
골드 5,분할 정복을 이용한 거듭제곱,1647,557,1090,0.3381906496660595
골드 5,0-1 너비 우선 탐색,565,190,375,0.336283185840708
골드 5,베이즈 정리,9,3,6,0.3333333333333333
골드 5,확장 유클리드 호제법,64,21,43,0.328125
골드 5,비트필드를 이용한 다이나믹 프로그래밍,223,73,150,0.3273542600896861
골드 5,최대 유량,49,16,33,0.32653061224489793
골드 5,외판원 순회 문제,342,110,232,0.3216374269005848
골드 5,희소 배열,140,44,96,0.3142857142857143
골드 5,오일러 피 함수,32,10,22,0.3125
골드 5,느리게 갱신되는 세그먼트 트리,68,21,47,0.3088235294117647
골드 5,매개 변수 탐색,5699,1743,3956,0.30584313037374977
골드 5,벨만–포드,322,95,227,0.2950310559006211
골드 5,단절점과 단절선,17,5,12,0.29411764705882354
골드 5,중간에서 만나기,99,29,70,0.29292929292929293
골드 5,트리에서의 다이나믹 프로그래밍,229,67,162,0.2925764192139738
골드 5,세그먼트 트리,959,271,688,0.28258602711157454
골드 5,스프라그–그런디 정리,37,10,27,0.2702702702702703
골드 5,선분 교차 판정,138,36,102,0.2608695652173913
골드 5,중국인의 나머지 정리,338,88,250,0.2603550295857988
골드 5,다차원 세그먼트 트리,4,1,3,0.25
골드 5,스위핑,496,104,392,0.20967741935483872
골드 5,고속 푸리에 변환,24,5,19,0.20833333333333334
골드 5,mo's,5,1,4,0.2
골드 5,물리학,52,10,42,0.19230769230769232
골드 5,회전하는 캘리퍼스,6,1,5,0.16666666666666666
골드 5,기댓값의 선형성,21,3,18,0.14285714285714285
골드 5,라빈–카프,17,1,16,0.058823529411764705
골드 5,무작위화,22,1,21,0.045454545454545456
골드 5,접미사 배열과 lcp 배열,25,1,24,0.04
골드 5,해싱,108,2,106,0.018518518518518517
골드 5,이중 연결 요소,1,0,1,0.0
골드 5,뫼비우스 반전 공식,2,0,2,0.0
골드 5,🏃🤔,7,0,7,0.0
골드 5,볼록 껍질을 이용한 최적화,9,0,9,0.0
골드 5,utf-8 입력 처리,1,0,1,0.0
골드 5,아호-코라식,1,0,1,0.0
골드 5,🧵,7,0,7,0.0
골드 5,가우스 소거법,3,0,3,0.0
골드 5,회문 트리,2,0,2,0.0
골드 5,선인장,1,0,1,0.0
골드 5,휴리스틱,1,0,1,0.0
골드 5,스플레이 트리,2,0,2,0.0
골드 5,양방향 탐색,2,0,2,0.0
골드 5,aliens 트릭,1,0,1,0.0
골드 5,🧑‍💻,7,0,7,0.0
골드 5,🌎👨‍💻📄🎱📖🧪,7,0,7,0.0
다이아몬드 1,이산 로그,1,1,0,1.0
다이아몬드 1,이산 제곱근,1,1,0,1.0
다이아몬드 1,볼록 다각형 내부의 점 판정,8,8,0,1.0
다이아몬드 1,담금질 기법,3,3,0,1.0
다이아몬드 1,오목 다각형 내부의 점 판정,1,1,0,1.0
다이아몬드 1,헝가리안,5,5,0,1.0
다이아몬드 1,매트로이드,2,2,0,1.0
다이아몬드 1,utf-8 입력 처리,1,1,0,1.0
다이아몬드 1,큐,26,25,1,0.9615384615384616
다이아몬드 1,배낭 문제,51,43,8,0.8431372549019608
다이아몬드 1,로프,16,13,3,0.8125
다이아몬드 1,머지 소트 트리,57,43,14,0.7543859649122807
다이아몬드 1,0-1 너비 우선 탐색,8,6,2,0.75
다이아몬드 1,확률론,54,39,15,0.7222222222222222
다이아몬드 1,피타고라스 정리,43,31,12,0.7209302325581395
다이아몬드 1,최소 비용 최대 유량,32,23,9,0.71875
다이아몬드 1,z,7,5,2,0.7142857142857143
다이아몬드 1,키타마사,14,10,4,0.7142857142857143
다이아몬드 1,다각형의 넓이,17,12,5,0.7058823529411765
다이아몬드 1,플로이드–와샬,40,28,12,0.7
다이아몬드 1,미적분학,36,25,11,0.6944444444444444
다이아몬드 1,모듈로 곱셈 역원,26,18,8,0.6923076923076923
다이아몬드 1,최대 유량 최소 컷 정리,19,13,6,0.6842105263157895
다이아몬드 1,순열 사이클 분할,22,15,7,0.6818181818181818
다이아몬드 1,구현,3480,2340,1140,0.6724137931034483
다이아몬드 1,물리학,18,12,6,0.6666666666666666
다이아몬드 1,기댓값의 선형성,6,4,2,0.6666666666666666
다이아몬드 1,춤추는 링크,3,2,1,0.6666666666666666
다이아몬드 1,크누스 x,3,2,1,0.6666666666666666
다이아몬드 1,사칙연산,1306,863,443,0.6607963246554365
다이아몬드 1,시뮬레이션,498,322,176,0.6465863453815262
다이아몬드 1,선형 계획법,14,9,5,0.6428571428571429
다이아몬드 1,쌍대성,14,9,5,0.6428571428571429
다이아몬드 1,유클리드 호제법,187,119,68,0.6363636363636364
다이아몬드 1,2-sat,27,17,10,0.6296296296296297
다이아몬드 1,중간에서 만나기,98,60,38,0.6122448979591837
다이아몬드 1,브루트포스 알고리즘,858,525,333,0.6118881118881119
다이아몬드 1,문자열,1762,1074,688,0.6095346197502838
다이아몬드 1,해시를 사용한 집합과 맵,174,106,68,0.6091954022988506
다이아몬드 1,조합론,311,187,124,0.6012861736334405
다이아몬드 1,정렬,1077,647,430,0.6007428040854225
다이아몬드 1,정규 표현식,5,3,2,0.6
다이아몬드 1,페르마의 소정리,25,15,10,0.6
다이아몬드 1,그린 정리,10,6,4,0.6
다이아몬드 1,오일러 경로,5,3,2,0.6
다이아몬드 1,뤼카 정리,5,3,2,0.6
다이아몬드 1,깊이 우선 탐색,416,249,167,0.5985576923076923
다이아몬드 1,스택,166,98,68,0.5903614457831325
다이아몬드 1,너비 우선 탐색,556,322,234,0.579136690647482
다이아몬드 1,병렬 이분 탐색,40,23,17,0.575
다이아몬드 1,홀의 결혼 정리,7,4,3,0.5714285714285714
다이아몬드 1,슬라이딩 윈도우,44,25,19,0.5681818181818182
다이아몬드 1,매내처,16,9,7,0.5625
다이아몬드 1,재귀,112,62,50,0.5535714285714286
다이아몬드 1,수학,4831,2670,2161,0.5526806044297247
다이아몬드 1,안정 결혼 문제,11,6,5,0.5454545454545454
다이아몬드 1,분할 정복을 이용한 거듭제곱,194,104,90,0.5360824742268041
다이아몬드 1,백트래킹,254,136,118,0.5354330708661418
다이아몬드 1,위상 정렬,70,37,33,0.5285714285714286
다이아몬드 1,비둘기집 원리,21,11,10,0.5238095238095238
다이아몬드 1,그래프 탐색,1163,608,555,0.5227858985382631
다이아몬드 1,오일러 피 함수,46,24,22,0.5217391304347826
다이아몬드 1,런타임 전의 전처리,121,63,58,0.5206611570247934
다이아몬드 1,게임 이론,313,162,151,0.5175718849840255
다이아몬드 1,비트 집합,82,42,40,0.5121951219512195
다이아몬드 1,매개 변수 탐색,168,86,82,0.5119047619047619
다이아몬드 1,선분 교차 판정,67,34,33,0.5074626865671642
다이아몬드 1,파싱,209,106,103,0.507177033492823
다이아몬드 1,값,83,42,41,0.5060240963855421
다이아몬드 1,좌표 압축,83,42,41,0.5060240963855421
다이아몬드 1,라빈–카프,16,8,8,0.5
다이아몬드 1,컷 트리,10,5,5,0.5
다이아몬드 1,링크,10,5,5,0.5
다이아몬드 1,오일러 지표 (χ=v-e+f),8,4,4,0.5
다이아몬드 1,이중 연결 요소,4,2,2,0.5
다이아몬드 1,임의 정밀도,275,136,139,0.49454545454545457
다이아몬드 1,큰 수 연산,275,136,139,0.49454545454545457
다이아몬드 1,kmp,139,68,71,0.4892086330935252
다이아몬드 1,mo's,114,55,59,0.4824561403508772
다이아몬드 1,그리디 알고리즘,1163,561,602,0.4823731728288908
다이아몬드 1,최대 유량,144,69,75,0.4791666666666667
다이아몬드 1,누적 합,571,270,301,0.47285464098073554
다이아몬드 1,작은 집합에서 큰 집합으로 합치는 테크닉,34,16,18,0.47058823529411764
다이아몬드 1,오일러 경로 테크닉,64,30,34,0.46875
다이아몬드 1,고속 푸리에 변환,158,74,84,0.46835443037974683
다이아몬드 1,단절점과 단절선,30,14,16,0.4666666666666667
다이아몬드 1,최소 스패닝 트리,157,73,84,0.46496815286624205
다이아몬드 1,벌래캠프–매시,13,6,7,0.46153846153846156
다이아몬드 1,정수론,1212,558,654,0.4603960396039604
다이아몬드 1,트라이,137,63,74,0.45985401459854014
다이아몬드 1,오프라인 쿼리,309,142,167,0.459546925566343
다이아몬드 1,다이나믹 프로그래밍,2481,1136,1345,0.45787988714228134
다이아몬드 1,아호-코라식,11,5,6,0.45454545454545453
다이아몬드 1,그래프 이론,2089,947,1142,0.453326950694112
다이아몬드 1,분리 집합,351,159,192,0.452991452991453
다이아몬드 1,히르쉬버그,31,14,17,0.45161290322580644
다이아몬드 1,두 포인터,235,105,130,0.44680851063829785
다이아몬드 1,폴라드 로,97,43,54,0.44329896907216493
다이아몬드 1,강한 연결 요소,70,31,39,0.44285714285714284
다이아몬드 1,자료 구조,3059,1349,1710,0.4409937888198758
다이아몬드 1,우선순위 큐,327,144,183,0.44036697247706424
다이아몬드 1,애드 혹,608,267,341,0.43914473684210525
다이아몬드 1,구성적,389,169,220,0.43444730077120824
다이아몬드 1,외판원 순회 문제,37,16,21,0.43243243243243246
다이아몬드 1,스프라그–그런디 정리,158,68,90,0.43037974683544306
다이아몬드 1,포함 배제의 원리,140,60,80,0.42857142857142855
다이아몬드 1,에라토스테네스의 체,211,89,122,0.4218009478672986
다이아몬드 1,3차원 기하학,19,8,11,0.42105263157894735
다이아몬드 1,가장 긴 증가하는 부분 수열: o(n log n),48,20,28,0.4166666666666667
다이아몬드 1,연결 리스트,12,5,7,0.4166666666666667
다이아몬드 1,기하학,692,288,404,0.4161849710982659
다이아몬드 1,소수 판정,450,186,264,0.41333333333333333
다이아몬드 1,크누스 최적화,22,9,13,0.4090909090909091
다이아몬드 1,세그먼트 트리,1659,671,988,0.40446051838456903
다이아몬드 1,덱,85,34,51,0.4
다이아몬드 1,밀러–라빈 소수 판별법,147,58,89,0.3945578231292517
다이아몬드 1,이분 탐색,1034,406,628,0.39264990328820115
다이아몬드 1,비트마스킹,530,208,322,0.39245283018867927
다이아몬드 1,볼록 껍질,128,50,78,0.390625
다이아몬드 1,중국인의 나머지 정리,31,12,19,0.3870967741935484
다이아몬드 1,제곱근 분할법,161,62,99,0.38509316770186336
다이아몬드 1,많은 조건 분기,494,189,305,0.3825910931174089
다이아몬드 1,트리에서의 다이나믹 프로그래밍,194,74,120,0.38144329896907214
다이아몬드 1,최소 공통 조상,189,72,117,0.38095238095238093
다이아몬드 1,휴리스틱,42,16,26,0.38095238095238093
다이아몬드 1,이분 매칭,116,44,72,0.3793103448275862
다이아몬드 1,트리,1154,434,720,0.37608318890814557
다이아몬드 1,양방향 탐색,8,3,5,0.375
다이아몬드 1,회전하는 캘리퍼스,40,15,25,0.375
다이아몬드 1,분할 정복,518,189,329,0.36486486486486486
다이아몬드 1,트리를 사용한 집합과 맵,192,70,122,0.3645833333333333
다이아몬드 1,함수 개형을 이용한 최적화,42,15,27,0.35714285714285715
다이아몬드 1,비트필드를 이용한 다이나믹 프로그래밍,220,77,143,0.35
다이아몬드 1,다익스트라,346,121,225,0.34971098265895956
다이아몬드 1,선형대수학,63,22,41,0.3492063492063492
다이아몬드 1,느리게 갱신되는 세그먼트 트리,493,170,323,0.3448275862068966
다이아몬드 1,벨만–포드,32,11,21,0.34375
다이아몬드 1,스플레이 트리,130,44,86,0.3384615384615385
다이아몬드 1,다차원 세그먼트 트리,6,2,4,0.3333333333333333
다이아몬드 1,접미사 배열과 lcp 배열,94,31,63,0.32978723404255317
다이아몬드 1,희소 배열,185,58,127,0.31351351351351353
다이아몬드 1,오프라인 동적 연결성 판정,42,13,29,0.30952380952380953
다이아몬드 1,뫼비우스 반전 공식,23,7,16,0.30434782608695654
다이아몬드 1,heavy-light 분할,135,41,94,0.3037037037037037
다이아몬드 1,스위핑,404,121,283,0.2995049504950495
다이아몬드 1,볼록 껍질을 이용한 최적화,110,31,79,0.2818181818181818
다이아몬드 1,삼분 탐색,22,6,16,0.2727272727272727
다이아몬드 1,분할 정복을 사용한 최적화,92,24,68,0.2608695652173913
다이아몬드 1,최소 외접원,8,2,6,0.25
다이아몬드 1,해싱,110,27,83,0.24545454545454545
다이아몬드 1,가우스 소거법,29,7,22,0.2413793103448276
다이아몬드 1,퍼시스턴트 세그먼트 트리,153,35,118,0.22875816993464052
다이아몬드 1,보로노이 다이어그램,37,8,29,0.21621621621621623
다이아몬드 1,센트로이드 분할,109,22,87,0.2018348623853211
다이아몬드 1,센트로이드,109,22,87,0.2018348623853211
다이아몬드 1,무작위화,100,20,80,0.2
다이아몬드 1,커넥션 프로파일을 이용한 다이나믹 프로그래밍,10,2,8,0.2
다이아몬드 1,평면 그래프,5,1,4,0.2
다이아몬드 1,덱을 이용한 다이나믹 프로그래밍,10,2,8,0.2
다이아몬드 1,수치해석,131,26,105,0.1984732824427481
다이아몬드 1,확장 유클리드 호제법,69,12,57,0.17391304347826086
다이아몬드 1,이분 그래프,47,8,39,0.1702127659574468
다이아몬드 1,aliens 트릭,76,11,65,0.14473684210526316
다이아몬드 1,단조 큐를 이용한 최적화,20,2,18,0.1
다이아몬드 1,현 그래프,12,1,11,0.08333333333333333
다이아몬드 1,트리 압축,4,0,4,0.0
다이아몬드 1,탑 트리,1,0,1,0.0
다이아몬드 2,스토어–바그너,2,2,0,1.0
다이아몬드 2,로프,7,7,0,1.0
다이아몬드 2,서큘레이션,1,1,0,1.0
다이아몬드 2,계산 이론,1,1,0,1.0
다이아몬드 2,회문 트리,2,2,0,1.0
다이아몬드 2,크누스 최적화,16,15,1,0.9375
다이아몬드 2,기댓값의 선형성,9,8,1,0.8888888888888888
다이아몬드 2,최소 비용 최대 유량,116,93,23,0.8017241379310345
다이아몬드 2,사칙연산,1390,1088,302,0.7827338129496403
다이아몬드 2,벌래캠프–매시,9,7,2,0.7777777777777778
다이아몬드 2,2-sat,36,28,8,0.7777777777777778
다이아몬드 2,큐,49,38,11,0.7755102040816326
다이아몬드 2,베이즈 정리,4,3,1,0.75
다이아몬드 2,회전하는 캘리퍼스,20,15,5,0.75
다이아몬드 2,매트로이드,12,9,3,0.75
다이아몬드 2,오프라인 동적 연결성 판정,40,30,10,0.75
다이아몬드 2,링크,27,20,7,0.7407407407407407
다이아몬드 2,컷 트리,27,20,7,0.7407407407407407
다이아몬드 2,키타마사,11,8,3,0.7272727272727273
다이아몬드 2,담금질 기법,29,21,8,0.7241379310344828
다이아몬드 2,덱을 이용한 다이나믹 프로그래밍,21,15,6,0.7142857142857143
다이아몬드 2,스플레이 트리,41,29,12,0.7073170731707317
다이아몬드 2,슬라이딩 윈도우,58,40,18,0.6896551724137931
다이아몬드 2,아호-코라식,46,31,15,0.6739130434782609
다이아몬드 2,안정 결혼 문제,12,8,4,0.6666666666666666
다이아몬드 2,이분 그래프,18,12,6,0.6666666666666666
다이아몬드 2,번사이드 보조정리,6,4,2,0.6666666666666666
다이아몬드 2,반평면 교집합,6,4,2,0.6666666666666666
다이아몬드 2,구현,3299,2176,1123,0.6595938163079721
다이아몬드 2,폴라드 로,88,57,31,0.6477272727272727
다이아몬드 2,피타고라스 정리,80,51,29,0.6375
다이아몬드 2,kmp,95,60,35,0.631578947368421
다이아몬드 2,플로이드–와샬,127,80,47,0.6299212598425197
다이아몬드 2,이산 로그,8,5,3,0.625
다이아몬드 2,브루트포스 알고리즘,1131,706,425,0.6242263483642794
다이아몬드 2,최대 유량,394,245,149,0.6218274111675127
다이아몬드 2,해시를 사용한 집합과 맵,247,151,96,0.611336032388664
다이아몬드 2,3차원 기하학,33,20,13,0.6060606060606061
다이아몬드 2,백트래킹,270,163,107,0.6037037037037037
다이아몬드 2,시뮬레이션,547,330,217,0.603290676416819
다이아몬드 2,모듈로 곱셈 역원,40,24,16,0.6
다이아몬드 2,통계학,5,3,2,0.6
다이아몬드 2,z,10,6,4,0.6
다이아몬드 2,이중 연결 요소,15,9,6,0.6
다이아몬드 2,매내처,30,18,12,0.6
다이아몬드 2,문자열,1472,880,592,0.5978260869565217
다이아몬드 2,게임 이론,190,112,78,0.5894736842105263
다이아몬드 2,오일러 피 함수,34,20,14,0.5882352941176471
다이아몬드 2,런타임 전의 전처리,75,44,31,0.5866666666666667
다이아몬드 2,분할 정복을 이용한 거듭제곱,238,139,99,0.5840336134453782
다이아몬드 2,홀의 결혼 정리,12,7,5,0.5833333333333334
다이아몬드 2,스프라그–그런디 정리,52,30,22,0.5769230769230769
다이아몬드 2,다차원 세그먼트 트리,33,19,14,0.5757575757575758
다이아몬드 2,휴리스틱,75,43,32,0.5733333333333334
다이아몬드 2,수학,5967,3411,2556,0.5716440422322775
다이아몬드 2,확률론,95,54,41,0.5684210526315789
다이아몬드 2,병렬 이분 탐색,69,39,30,0.5652173913043478
다이아몬드 2,오일러 경로 테크닉,87,49,38,0.5632183908045977
다이아몬드 2,재귀,128,72,56,0.5625
다이아몬드 2,트리를 사용한 집합과 맵,230,128,102,0.5565217391304348
다이아몬드 2,밀러–라빈 소수 판별법,137,76,61,0.5547445255474452
다이아몬드 2,최대 유량 최소 컷 정리,190,105,85,0.5526315789473685
다이아몬드 2,배낭 문제,181,100,81,0.5524861878453039
다이아몬드 2,스택,334,184,150,0.5508982035928144
다이아몬드 2,순열 사이클 분할,51,28,23,0.5490196078431373
다이아몬드 2,퍼시스턴트 세그먼트 트리,75,41,34,0.5466666666666666
다이아몬드 2,좌표 압축,220,120,100,0.5454545454545454
다이아몬드 2,값,220,120,100,0.5454545454545454
다이아몬드 2,0-1 너비 우선 탐색,24,13,11,0.5416666666666666
다이아몬드 2,정렬,1379,741,638,0.5373459028281363
다이아몬드 2,강한 연결 요소,125,66,59,0.528
다이아몬드 2,다익스트라,504,266,238,0.5277777777777778
다이아몬드 2,조합론,512,270,242,0.52734375
다이아몬드 2,뤼카 정리,19,10,9,0.5263157894736842
다이아몬드 2,너비 우선 탐색,782,408,374,0.5217391304347826
다이아몬드 2,누적 합,830,426,404,0.5132530120481927
다이아몬드 2,비둘기집 원리,53,27,26,0.5094339622641509
다이아몬드 2,머지 소트 트리,53,27,26,0.5094339622641509
다이아몬드 2,단절점과 단절선,53,27,26,0.5094339622641509
다이아몬드 2,유클리드 호제법,168,85,83,0.5059523809523809
다이아몬드 2,다이나믹 프로그래밍,3519,1761,1758,0.5004262574595055
다이아몬드 2,가장 긴 증가하는 부분 수열: o(n log n),122,61,61,0.5
다이아몬드 2,단조 큐를 이용한 최적화,2,1,1,0.5
다이아몬드 2,양방향 탐색,8,4,4,0.5
다이아몬드 2,가우스 소거법,76,38,38,0.5
다이아몬드 2,그래프 탐색,1761,877,884,0.49801249290176036
다이아몬드 2,에라토스테네스의 체,189,94,95,0.4973544973544973
다이아몬드 2,분할 정복을 사용한 최적화,145,72,73,0.496551724137931
다이아몬드 2,자료 구조,3861,1907,1954,0.49391349391349393
다이아몬드 2,트라이,209,103,106,0.49282296650717705
다이아몬드 2,그래프 이론,3142,1544,1598,0.49140674729471673
다이아몬드 2,덱,112,55,57,0.49107142857142855
다이아몬드 2,정수론,1381,673,708,0.4873280231716148
다이아몬드 2,분리 집합,425,206,219,0.48470588235294115
다이아몬드 2,세그먼트 트리,1813,874,939,0.4820739106453392
다이아몬드 2,중국인의 나머지 정리,27,13,14,0.48148148148148145
다이아몬드 2,깊이 우선 탐색,792,381,411,0.4810606060606061
다이아몬드 2,오프라인 쿼리,460,217,243,0.4717391304347826
다이아몬드 2,이분 매칭,164,77,87,0.4695121951219512
다이아몬드 2,그리디 알고리즘,1840,858,982,0.46630434782608693
다이아몬드 2,heavy-light 분할,131,61,70,0.46564885496183206
다이아몬드 2,트리,1590,739,851,0.4647798742138365
다이아몬드 2,접미사 배열과 lcp 배열,173,80,93,0.4624277456647399
다이아몬드 2,페르마의 소정리,39,18,21,0.46153846153846156
다이아몬드 2,고속 푸리에 변환,180,83,97,0.46111111111111114
다이아몬드 2,정규 표현식,24,11,13,0.4583333333333333
다이아몬드 2,소수 판정,499,228,271,0.45691382765531063
다이아몬드 2,볼록 껍질을 이용한 최적화,127,57,70,0.44881889763779526
다이아몬드 2,분할 정복,633,283,350,0.4470774091627172
다이아몬드 2,mo's,245,109,136,0.4448979591836735
다이아몬드 2,우선순위 큐,477,212,265,0.4444444444444444
다이아몬드 2,느리게 갱신되는 세그먼트 트리,460,203,257,0.44130434782608696
다이아몬드 2,미적분학,59,26,33,0.4406779661016949
다이아몬드 2,트리에서의 다이나믹 프로그래밍,420,185,235,0.44047619047619047
다이아몬드 2,선형대수학,139,61,78,0.43884892086330934
다이아몬드 2,비트마스킹,647,282,365,0.43585780525502316
다이아몬드 2,중간에서 만나기,101,44,57,0.43564356435643564
다이아몬드 2,벨만–포드,23,10,13,0.43478260869565216
다이아몬드 2,무작위화,115,50,65,0.43478260869565216
다이아몬드 2,최소 스패닝 트리,295,128,167,0.43389830508474575
다이아몬드 2,함수 개형을 이용한 최적화,67,29,38,0.43283582089552236
다이아몬드 2,선인장,14,6,8,0.42857142857142855
다이아몬드 2,작은 집합에서 큰 집합으로 합치는 테크닉,73,31,42,0.4246575342465753
다이아몬드 2,최소 공통 조상,251,106,145,0.42231075697211157
다이아몬드 2,센트로이드,121,50,71,0.4132231404958678
다이아몬드 2,비트 집합,17,7,10,0.4117647058823529
다이아몬드 2,센트로이드 분할,120,49,71,0.4083333333333333
다이아몬드 2,두 포인터,365,148,217,0.4054794520547945
다이아몬드 2,이분 탐색,1442,577,865,0.4001386962552011
다이아몬드 2,연결 리스트,25,10,15,0.4
다이아몬드 2,임의 정밀도,273,109,164,0.3992673992673993
다이아몬드 2,큰 수 연산,273,109,164,0.3992673992673993
다이아몬드 2,많은 조건 분기,524,209,315,0.3988549618320611
다이아몬드 2,비트필드를 이용한 다이나믹 프로그래밍,282,111,171,0.39361702127659576
다이아몬드 2,오일러 지표 (χ=v-e+f),18,7,11,0.3888888888888889
다이아몬드 2,애드 혹,831,323,508,0.38868832731648617
다이아몬드 2,위상 정렬,172,66,106,0.38372093023255816
다이아몬드 2,히르쉬버그,8,3,5,0.375
다이아몬드 2,파싱,184,69,115,0.375
다이아몬드 2,스위핑,536,197,339,0.3675373134328358
다이아몬드 2,외판원 순회 문제,102,37,65,0.3627450980392157
다이아몬드 2,구성적,673,238,435,0.3536404160475483
다이아몬드 2,기하학,1154,402,752,0.3483535528596187
다이아몬드 2,포함 배제의 원리,178,59,119,0.33146067415730335
다이아몬드 2,최소 외접원,34,11,23,0.3235294117647059
다이아몬드 2,오일러 경로,28,9,19,0.32142857142857145
다이아몬드 2,제곱근 분할법,284,90,194,0.31690140845070425
다이아몬드 2,희소 배열,151,46,105,0.304635761589404
다이아몬드 2,aliens 트릭,23,7,16,0.30434782608695654
다이아몬드 2,매개 변수 탐색,309,91,218,0.29449838187702265
다이아몬드 2,라빈–카프,106,31,75,0.29245283018867924
다이아몬드 2,오목 다각형 내부의 점 판정,7,2,5,0.2857142857142857
다이아몬드 2,물리학,18,5,13,0.2777777777777778
다이아몬드 2,해싱,266,71,195,0.2669172932330827
다이아몬드 2,뫼비우스 반전 공식,45,11,34,0.24444444444444444
다이아몬드 2,볼록 껍질,331,80,251,0.24169184290030213
다이아몬드 2,쌍대성,9,2,7,0.2222222222222222
다이아몬드 2,선형 계획법,9,2,7,0.2222222222222222
다이아몬드 2,볼록 다각형 내부의 점 판정,56,12,44,0.21428571428571427
다이아몬드 2,삼분 탐색,64,13,51,0.203125
다이아몬드 2,현 그래프,5,1,4,0.2
다이아몬드 2,확장 유클리드 호제법,35,7,28,0.2
다이아몬드 2,다각형의 넓이,130,21,109,0.16153846153846155
다이아몬드 2,평면 그래프,25,4,21,0.16
다이아몬드 2,트리 동형 사상,33,5,28,0.15151515151515152
다이아몬드 2,선분 교차 판정,175,26,149,0.14857142857142858
다이아몬드 2,수치해석,84,10,74,0.11904761904761904
다이아몬드 2,🌎👨‍💻📄🎱📖🧪,6,0,6,0.0
다이아몬드 2,춤추는 링크,1,0,1,0.0
다이아몬드 2,a*,1,0,1,0.0
다이아몬드 2,🧵,6,0,6,0.0
다이아몬드 2,탑 트리,4,0,4,0.0
다이아몬드 2,🧑‍💻,6,0,6,0.0
다이아몬드 2,크누스 x,1,0,1,0.0
다이아몬드 2,🏃🤔,6,0,6,0.0
다이아몬드 3,오목 다각형 내부의 점 판정,1,1,0,1.0
다이아몬드 3,이산 제곱근,1,1,0,1.0
다이아몬드 3,안정 결혼 문제,1,1,0,1.0
다이아몬드 3,이산 로그,1,1,0,1.0
다이아몬드 3,계산 이론,1,1,0,1.0
다이아몬드 3,단조 큐를 이용한 최적화,4,4,0,1.0
다이아몬드 3,보로노이 다이어그램,2,2,0,1.0
다이아몬드 3,뤼카 정리,14,13,1,0.9285714285714286
다이아몬드 3,사칙연산,1349,1148,201,0.8510007412898444
다이아몬드 3,담금질 기법,194,165,29,0.8505154639175257
다이아몬드 3,매내처,20,17,3,0.85
다이아몬드 3,연결 리스트,20,17,3,0.85
다이아몬드 3,휴리스틱,216,181,35,0.8379629629629629
다이아몬드 3,현 그래프,6,5,1,0.8333333333333334
다이아몬드 3,다차원 세그먼트 트리,12,10,2,0.8333333333333334
다이아몬드 3,평면 그래프,14,11,3,0.7857142857142857
다이아몬드 3,2-sat,72,56,16,0.7777777777777778
다이아몬드 3,큐,58,45,13,0.7758620689655172
다이아몬드 3,히르쉬버그,8,6,2,0.75
다이아몬드 3,커넥션 프로파일을 이용한 다이나믹 프로그래밍,16,12,4,0.75
다이아몬드 3,해시를 사용한 집합과 맵,325,238,87,0.7323076923076923
다이아몬드 3,구현,4518,3264,1254,0.7224435590969456
다이아몬드 3,최소 비용 최대 유량,187,134,53,0.7165775401069518
다이아몬드 3,선형 계획법,7,5,2,0.7142857142857143
다이아몬드 3,쌍대성,7,5,2,0.7142857142857143
다이아몬드 3,슬라이딩 윈도우,108,75,33,0.6944444444444444
다이아몬드 3,페르마의 소정리,85,58,27,0.6823529411764706
다이아몬드 3,함수 개형을 이용한 최적화,22,15,7,0.6818181818181818
다이아몬드 3,피타고라스 정리,72,49,23,0.6805555555555556
다이아몬드 3,로프,34,23,11,0.6764705882352942
다이아몬드 3,조합론,530,355,175,0.6698113207547169
다이아몬드 3,문자열,2071,1368,703,0.6605504587155964
다이아몬드 3,시뮬레이션,906,589,317,0.6501103752759382
다이아몬드 3,두 포인터,342,220,122,0.6432748538011696
다이아몬드 3,수학,7222,4631,2591,0.6412351149266131
다이아몬드 3,모듈로 곱셈 역원,102,65,37,0.6372549019607843
다이아몬드 3,정규 표현식,11,7,4,0.6363636363636364
다이아몬드 3,브루트포스 알고리즘,1856,1163,693,0.6266163793103449
다이아몬드 3,분할 정복을 이용한 거듭제곱,423,265,158,0.6264775413711584
다이아몬드 3,덱,123,77,46,0.6260162601626016
다이아몬드 3,배낭 문제,357,222,135,0.6218487394957983
다이아몬드 3,비트필드를 이용한 다이나믹 프로그래밍,311,193,118,0.6205787781350482
다이아몬드 3,깊이 우선 탐색,1055,650,405,0.6161137440758294
다이아몬드 3,재귀,200,123,77,0.615
다이아몬드 3,오일러 경로 테크닉,171,105,66,0.6140350877192983
다이아몬드 3,스프라그–그런디 정리,134,82,52,0.6119402985074627
다이아몬드 3,에라토스테네스의 체,359,219,140,0.6100278551532033
다이아몬드 3,비둘기집 원리,41,25,16,0.6097560975609756
다이아몬드 3,정렬,1839,1121,718,0.6095704187058184
다이아몬드 3,트리를 사용한 집합과 맵,278,169,109,0.6079136690647482
다이아몬드 3,뫼비우스 반전 공식,56,34,22,0.6071428571428571
다이아몬드 3,누적 합,895,540,355,0.6033519553072626
다이아몬드 3,런타임 전의 전처리,138,83,55,0.6014492753623188
다이아몬드 3,비트마스킹,706,424,282,0.6005665722379604
다이아몬드 3,큰 수 연산,247,148,99,0.5991902834008097
다이아몬드 3,임의 정밀도,247,148,99,0.5991902834008097
다이아몬드 3,강한 연결 요소,244,146,98,0.5983606557377049
다이아몬드 3,스택,387,231,156,0.5968992248062015
다이아몬드 3,컷 트리,42,25,17,0.5952380952380952
다이아몬드 3,링크,42,25,17,0.5952380952380952
다이아몬드 3,우선순위 큐,538,320,218,0.5947955390334573
다이아몬드 3,오일러 피 함수,96,57,39,0.59375
다이아몬드 3,이분 매칭,416,247,169,0.59375
다이아몬드 3,머지 소트 트리,86,51,35,0.5930232558139535
다이아몬드 3,분리 집합,644,381,263,0.5916149068322981
다이아몬드 3,순열 사이클 분할,66,39,27,0.5909090909090909
다이아몬드 3,크누스 최적화,22,13,9,0.5909090909090909
다이아몬드 3,유클리드 호제법,233,137,96,0.5879828326180258
다이아몬드 3,다이나믹 프로그래밍,4630,2706,1924,0.5844492440604752
다이아몬드 3,kmp,281,161,120,0.5729537366548043
다이아몬드 3,너비 우선 탐색,1496,856,640,0.5721925133689839
다이아몬드 3,그래프 탐색,2659,1520,1139,0.571643474990598
다이아몬드 3,소수 판정,754,430,324,0.5702917771883289
다이아몬드 3,heavy-light 분할,114,65,49,0.5701754385964912
다이아몬드 3,정수론,2192,1247,945,0.5688868613138686
다이아몬드 3,파싱,245,139,106,0.5673469387755102
다이아몬드 3,헝가리안,62,35,27,0.5645161290322581
다이아몬드 3,위상 정렬,242,136,106,0.5619834710743802
다이아몬드 3,선형대수학,171,96,75,0.5614035087719298
다이아몬드 3,밀러–라빈 소수 판별법,199,110,89,0.5527638190954773
다이아몬드 3,자료 구조,5037,2775,2262,0.55092316855271
다이아몬드 3,그리디 알고리즘,1984,1092,892,0.5504032258064516
다이아몬드 3,트리에서의 다이나믹 프로그래밍,331,181,150,0.5468277945619335
다이아몬드 3,백트래킹,523,284,239,0.5430210325047801
다이아몬드 3,포함 배제의 원리,176,95,81,0.5397727272727273
다이아몬드 3,그래프 이론,4834,2608,2226,0.5395117914770376
다이아몬드 3,작은 집합에서 큰 집합으로 합치는 테크닉,49,26,23,0.5306122448979592
다이아몬드 3,비트 집합,17,9,8,0.5294117647058824
다이아몬드 3,최소 스패닝 트리,320,168,152,0.525
다이아몬드 3,느리게 갱신되는 세그먼트 트리,421,221,200,0.5249406175771971
다이아몬드 3,폴라드 로,151,78,73,0.5165562913907285
다이아몬드 3,최소 공통 조상,514,265,249,0.5155642023346303
다이아몬드 3,오일러 경로,37,19,18,0.5135135135135135
다이아몬드 3,트리,2073,1064,1009,0.513265798359865
다이아몬드 3,접미사 배열과 lcp 배열,193,99,94,0.5129533678756477
다이아몬드 3,가장 긴 증가하는 부분 수열: o(n log n),119,61,58,0.5126050420168067
다이아몬드 3,분할 정복을 사용한 최적화,171,87,84,0.5087719298245614
다이아몬드 3,병렬 이분 탐색,136,69,67,0.5073529411764706
다이아몬드 3,이분 탐색,1588,804,784,0.5062972292191436
다이아몬드 3,무작위화,143,72,71,0.5034965034965035
다이아몬드 3,세그먼트 트리,2315,1164,1151,0.5028077753779697
다이아몬드 3,트라이,305,153,152,0.5016393442622951
다이아몬드 3,덱을 이용한 다이나믹 프로그래밍,38,19,19,0.5
다이아몬드 3,물리학,30,15,15,0.5
다이아몬드 3,회문 트리,2,1,1,0.5
다이아몬드 3,외판원 순회 문제,56,28,28,0.5
다이아몬드 3,애드 혹,727,359,368,0.4938101788170564
다이아몬드 3,스위핑,600,296,304,0.49333333333333335
다이아몬드 3,최대 유량,747,367,380,0.49129852744310576
다이아몬드 3,볼록 다각형 내부의 점 판정,45,22,23,0.4888888888888889
다이아몬드 3,삼분 탐색,43,21,22,0.4883720930232558
다이아몬드 3,희소 배열,328,159,169,0.4847560975609756
다이아몬드 3,라빈–카프,58,28,30,0.4827586206896552
다이아몬드 3,가우스 소거법,114,55,59,0.4824561403508772
다이아몬드 3,좌표 압축,247,118,129,0.4777327935222672
다이아몬드 3,값,247,118,129,0.4777327935222672
다이아몬드 3,플로이드–와샬,210,100,110,0.47619047619047616
다이아몬드 3,고속 푸리에 변환,334,159,175,0.47604790419161674
다이아몬드 3,오프라인 쿼리,525,249,276,0.4742857142857143
다이아몬드 3,게임 이론,420,199,221,0.4738095238095238
다이아몬드 3,다익스트라,1204,567,637,0.47093023255813954
다이아몬드 3,오프라인 동적 연결성 판정,34,16,18,0.47058823529411764
다이아몬드 3,구성적,517,242,275,0.46808510638297873
다이아몬드 3,확률론,239,110,129,0.4602510460251046
다이아몬드 3,매개 변수 탐색,380,174,206,0.45789473684210524
다이아몬드 3,키타마사,11,5,6,0.45454545454545453
다이아몬드 3,분할 정복,718,325,393,0.45264623955431754
다이아몬드 3,이분 그래프,40,18,22,0.45
다이아몬드 3,번사이드 보조정리,18,8,10,0.4444444444444444
다이아몬드 3,중간에서 만나기,111,49,62,0.44144144144144143
다이아몬드 3,mo's,298,131,167,0.4395973154362416
다이아몬드 3,볼록 껍질,265,116,149,0.4377358490566038
다이아몬드 3,많은 조건 분기,522,225,297,0.43103448275862066
다이아몬드 3,기하학,1289,554,735,0.42979053529868116
다이아몬드 3,아호-코라식,112,48,64,0.42857142857142855
다이아몬드 3,홀의 결혼 정리,7,3,4,0.42857142857142855
다이아몬드 3,3차원 기하학,86,35,51,0.4069767441860465
다이아몬드 3,벨만–포드,67,27,40,0.40298507462686567
다이아몬드 3,해싱,150,60,90,0.4
다이아몬드 3,중국인의 나머지 정리,83,33,50,0.39759036144578314
다이아몬드 3,볼록 껍질을 이용한 최적화,368,145,223,0.39402173913043476
다이아몬드 3,회전하는 캘리퍼스,87,34,53,0.39080459770114945
다이아몬드 3,기댓값의 선형성,41,16,25,0.3902439024390244
다이아몬드 3,퍼시스턴트 세그먼트 트리,167,65,102,0.38922155688622756
다이아몬드 3,오일러 지표 (χ=v-e+f),13,5,8,0.38461538461538464
다이아몬드 3,선분 교차 판정,187,71,116,0.37967914438502676
다이아몬드 3,미적분학,162,61,101,0.3765432098765432
다이아몬드 3,스플레이 트리,139,51,88,0.3669064748201439
다이아몬드 3,최대 유량 최소 컷 정리,185,67,118,0.3621621621621622
다이아몬드 3,z,57,20,37,0.3508771929824561
다이아몬드 3,벌래캠프–매시,55,19,36,0.34545454545454546
다이아몬드 3,확장 유클리드 호제법,94,32,62,0.3404255319148936
다이아몬드 3,제곱근 분할법,221,74,147,0.334841628959276
다이아몬드 3,단절점과 단절선,105,35,70,0.3333333333333333
다이아몬드 3,4차원 이상의 기하학,3,1,2,0.3333333333333333
다이아몬드 3,0-1 너비 우선 탐색,126,42,84,0.3333333333333333
다이아몬드 3,트리 압축,9,3,6,0.3333333333333333
다이아몬드 3,utf-8 입력 처리,3,1,2,0.3333333333333333
다이아몬드 3,트리 동형 사상,15,5,10,0.3333333333333333
다이아몬드 3,다각형의 넓이,76,25,51,0.32894736842105265
다이아몬드 3,수치해석,102,32,70,0.3137254901960784
다이아몬드 3,선인장,10,3,7,0.3
다이아몬드 3,유향 최소 신장 트리,23,6,17,0.2608695652173913
다이아몬드 3,픽의 정리,4,1,3,0.25
다이아몬드 3,이중 연결 요소,24,5,19,0.20833333333333334
다이아몬드 3,그린 정리,39,8,31,0.20512820512820512
다이아몬드 3,스토어–바그너,5,1,4,0.2
다이아몬드 3,일반적인 매칭,5,1,4,0.2
다이아몬드 3,양방향 탐색,23,4,19,0.17391304347826086
다이아몬드 3,센트로이드 분할,68,11,57,0.16176470588235295
다이아몬드 3,센트로이드,68,11,57,0.16176470588235295
다이아몬드 3,aliens 트릭,25,4,21,0.16
다이아몬드 3,최소 외접원,96,15,81,0.15625
다이아몬드 3,서큘레이션,20,3,17,0.15
다이아몬드 3,춤추는 링크,7,1,6,0.14285714285714285
다이아몬드 3,크누스 x,7,1,6,0.14285714285714285
다이아몬드 3,베이즈 정리,24,3,21,0.125
다이아몬드 3,통계학,32,0,32,0.0
다이아몬드 3,🧵,2,0,2,0.0
다이아몬드 3,🏃🤔,2,0,2,0.0
다이아몬드 3,🧑‍💻,2,0,2,0.0
다이아몬드 3,🌎👨‍💻📄🎱📖🧪,2,0,2,0.0
다이아몬드 4,로프,3,3,0,1.0
다이아몬드 4,오프라인 동적 연결성 판정,6,6,0,1.0
다이아몬드 4,이산 로그,1,1,0,1.0
다이아몬드 4,반평면 교집합,3,3,0,1.0
다이아몬드 4,인터프리터,2,2,0,1.0
다이아몬드 4,물리학,5,5,0,1.0
다이아몬드 4,담금질 기법,120,101,19,0.8416666666666667
다이아몬드 4,사칙연산,2148,1545,603,0.7192737430167597
다이아몬드 4,오일러 지표 (χ=v-e+f),7,5,2,0.7142857142857143
다이아몬드 4,비둘기집 원리,31,22,9,0.7096774193548387
다이아몬드 4,크누스 x,17,12,5,0.7058823529411765
다이아몬드 4,춤추는 링크,17,12,5,0.7058823529411765
다이아몬드 4,가우스 소거법,23,16,7,0.6956521739130435
다이아몬드 4,피타고라스 정리,82,55,27,0.6707317073170732
다이아몬드 4,큐,111,73,38,0.6576576576576577
다이아몬드 4,연결 리스트,23,15,8,0.6521739130434783
다이아몬드 4,다차원 세그먼트 트리,17,11,6,0.6470588235294118
다이아몬드 4,순열 사이클 분할,30,19,11,0.6333333333333333
다이아몬드 4,구현,5846,3683,2163,0.6300034211426616
다이아몬드 4,확률론,89,56,33,0.6292134831460674
다이아몬드 4,해시를 사용한 집합과 맵,306,192,114,0.6274509803921569
다이아몬드 4,슬라이딩 윈도우,113,70,43,0.6194690265486725
다이아몬드 4,휴리스틱,204,125,79,0.6127450980392157
다이아몬드 4,뫼비우스 반전 공식,5,3,2,0.6
다이아몬드 4,재귀,291,173,118,0.5945017182130584
다이아몬드 4,트리를 사용한 집합과 맵,231,137,94,0.5930735930735931
다이아몬드 4,수학,7775,4529,3246,0.582508038585209
다이아몬드 4,0-1 너비 우선 탐색,26,15,11,0.5769230769230769
다이아몬드 4,문자열,2345,1350,995,0.5756929637526652
다이아몬드 4,폴라드 로,101,58,43,0.5742574257425742
다이아몬드 4,밀러–라빈 소수 판별법,125,71,54,0.568
다이아몬드 4,스택,429,243,186,0.5664335664335665
다이아몬드 4,3차원 기하학,32,18,14,0.5625
다이아몬드 4,정렬,2053,1154,899,0.5621042377009254
다이아몬드 4,커넥션 프로파일을 이용한 다이나믹 프로그래밍,9,5,4,0.5555555555555556
다이아몬드 4,최소 비용 최대 유량,94,52,42,0.5531914893617021
다이아몬드 4,머지 소트 트리,95,52,43,0.5473684210526316
다이아몬드 4,브루트포스 알고리즘,2372,1297,1075,0.5467959527824621
다이아몬드 4,스플레이 트리,11,6,5,0.5454545454545454
다이아몬드 4,누적 합,688,372,316,0.5406976744186046
다이아몬드 4,2-sat,113,61,52,0.5398230088495575
다이아몬드 4,게임 이론,420,226,194,0.5380952380952381
다이아몬드 4,오일러 피 함수,41,22,19,0.5365853658536586
다이아몬드 4,조합론,571,304,267,0.532399299474606
다이아몬드 4,스프라그–그런디 정리,177,94,83,0.5310734463276836
다이아몬드 4,깊이 우선 탐색,974,515,459,0.528747433264887
다이아몬드 4,키타마사,19,10,9,0.5263157894736842
다이아몬드 4,중국인의 나머지 정리,42,22,20,0.5238095238095238
다이아몬드 4,백트래킹,688,360,328,0.5232558139534884
다이아몬드 4,모듈로 곱셈 역원,67,35,32,0.5223880597014925
다이아몬드 4,두 포인터,311,162,149,0.5209003215434084
다이아몬드 4,우선순위 큐,467,243,224,0.5203426124197003
다이아몬드 4,구성적,494,255,239,0.5161943319838057
다이아몬드 4,가장 긴 증가하는 부분 수열: o(n log n),166,85,81,0.5120481927710844
다이아몬드 4,포함 배제의 원리,147,75,72,0.5102040816326531
다이아몬드 4,그리디 알고리즘,2262,1150,1112,0.5083996463306808
다이아몬드 4,희소 배열,181,92,89,0.5082872928176796
다이아몬드 4,파싱,195,98,97,0.5025641025641026
다이아몬드 4,유클리드 호제법,259,130,129,0.5019305019305019
다이아몬드 4,헝가리안,6,3,3,0.5
다이아몬드 4,링크,6,3,3,0.5
다이아몬드 4,선형 계획법,2,1,1,0.5
다이아몬드 4,선형대수학,114,57,57,0.5
다이아몬드 4,컷 트리,6,3,3,0.5
다이아몬드 4,자료 구조,4254,2111,2143,0.49623883403855196
다이아몬드 4,최대 유량,399,196,203,0.49122807017543857
다이아몬드 4,소수 판정,652,320,332,0.49079754601226994
다이아몬드 4,시뮬레이션,970,475,495,0.4896907216494845
다이아몬드 4,트리에서의 다이나믹 프로그래밍,207,101,106,0.48792270531400966
다이아몬드 4,그래프 탐색,2498,1216,1282,0.4867894315452362
다이아몬드 4,정수론,1754,847,907,0.4828962371721779
다이아몬드 4,페르마의 소정리,48,23,25,0.4791666666666667
다이아몬드 4,에라토스테네스의 체,408,194,214,0.47549019607843135
다이아몬드 4,최소 공통 조상,302,143,159,0.4735099337748344
다이아몬드 4,너비 우선 탐색,1594,754,840,0.4730238393977415
다이아몬드 4,이분 매칭,284,133,151,0.46830985915492956
다이아몬드 4,분할 정복,577,270,307,0.4679376083188908
다이아몬드 4,플로이드–와샬,223,104,119,0.4663677130044843
다이아몬드 4,최대 유량 최소 컷 정리,134,62,72,0.4626865671641791
다이아몬드 4,비트 집합,13,6,7,0.46153846153846156
다이아몬드 4,트리,1348,622,726,0.46142433234421365
다이아몬드 4,강한 연결 요소,258,119,139,0.46124031007751937
다이아몬드 4,트라이,256,118,138,0.4609375
다이아몬드 4,분할 정복을 이용한 거듭제곱,437,200,237,0.4576659038901602
다이아몬드 4,비트마스킹,741,339,402,0.4574898785425101
다이아몬드 4,그래프 이론,3966,1813,2153,0.45713565305093296
다이아몬드 4,고속 푸리에 변환,240,109,131,0.45416666666666666
다이아몬드 4,애드 혹,714,324,390,0.453781512605042
다이아몬드 4,세그먼트 트리,1863,839,1024,0.45034889962426194
다이아몬드 4,다각형의 넓이,36,16,20,0.4444444444444444
다이아몬드 4,서큘레이션,9,4,5,0.4444444444444444
다이아몬드 4,큰 수 연산,401,178,223,0.44389027431421446
다이아몬드 4,임의 정밀도,401,178,223,0.44389027431421446
다이아몬드 4,다이나믹 프로그래밍,4649,2063,2586,0.4437513443751344
다이아몬드 4,느리게 갱신되는 세그먼트 트리,468,207,261,0.4423076923076923
다이아몬드 4,단절점과 단절선,32,14,18,0.4375
다이아몬드 4,함수 개형을 이용한 최적화,32,14,18,0.4375
다이아몬드 4,크누스 최적화,16,7,9,0.4375
다이아몬드 4,최소 스패닝 트리,234,101,133,0.43162393162393164
다이아몬드 4,분리 집합,442,190,252,0.4298642533936652
다이아몬드 4,접미사 배열과 lcp 배열,185,79,106,0.42702702702702705
다이아몬드 4,스위핑,452,192,260,0.4247787610619469
다이아몬드 4,벌래캠프–매시,26,11,15,0.4230769230769231
다이아몬드 4,덱,140,59,81,0.42142857142857143
다이아몬드 4,오일러 경로 테크닉,129,54,75,0.4186046511627907
다이아몬드 4,kmp,273,114,159,0.4175824175824176
다이아몬드 4,덱을 이용한 다이나믹 프로그래밍,27,11,16,0.4074074074074074
다이아몬드 4,기하학,1173,477,696,0.40664961636828645
다이아몬드 4,이분 탐색,1450,586,864,0.40413793103448276
다이아몬드 4,중간에서 만나기,120,48,72,0.4
다이아몬드 4,값,273,107,166,0.39194139194139194
다이아몬드 4,좌표 압축,273,107,166,0.39194139194139194
다이아몬드 4,배낭 문제,281,110,171,0.3914590747330961
다이아몬드 4,다익스트라,504,197,307,0.39087301587301587
다이아몬드 4,제곱근 분할법,227,88,139,0.3876651982378855
다이아몬드 4,많은 조건 분기,451,174,277,0.3858093126385809
다이아몬드 4,이분 그래프,13,5,8,0.38461538461538464
다이아몬드 4,위상 정렬,194,74,120,0.38144329896907214
다이아몬드 4,분할 정복을 사용한 최적화,105,40,65,0.38095238095238093
다이아몬드 4,오프라인 쿼리,650,247,403,0.38
다이아몬드 4,z,48,18,30,0.375
다이아몬드 4,뤼카 정리,24,9,15,0.375
다이아몬드 4,기댓값의 선형성,16,6,10,0.375
다이아몬드 4,볼록 다각형 내부의 점 판정,38,14,24,0.3684210526315789
다이아몬드 4,런타임 전의 전처리,136,50,86,0.36764705882352944
다이아몬드 4,heavy-light 분할,115,42,73,0.3652173913043478
다이아몬드 4,매개 변수 탐색,285,104,181,0.3649122807017544
다이아몬드 4,삼분 탐색,47,17,30,0.3617021276595745
다이아몬드 4,mo's,432,155,277,0.3587962962962963
다이아몬드 4,작은 집합에서 큰 집합으로 합치는 테크닉,53,19,34,0.3584905660377358
다이아몬드 4,무작위화,164,58,106,0.35365853658536583
다이아몬드 4,외판원 순회 문제,105,37,68,0.3523809523809524
다이아몬드 4,벨만–포드,54,19,35,0.35185185185185186
다이아몬드 4,확장 유클리드 호제법,57,20,37,0.3508771929824561
다이아몬드 4,오목 다각형 내부의 점 판정,6,2,4,0.3333333333333333
다이아몬드 4,정규 표현식,42,14,28,0.3333333333333333
다이아몬드 4,라빈–카프,70,23,47,0.32857142857142857
다이아몬드 4,비트필드를 이용한 다이나믹 프로그래밍,369,119,250,0.3224932249322493
다이아몬드 4,회전하는 캘리퍼스,81,26,55,0.32098765432098764
다이아몬드 4,매내처,60,19,41,0.31666666666666665
다이아몬드 4,볼록 껍질,328,103,225,0.31402439024390244
다이아몬드 4,최소 외접원,73,22,51,0.3013698630136986
다이아몬드 4,퍼시스턴트 세그먼트 트리,87,26,61,0.2988505747126437
다이아몬드 4,해싱,155,46,109,0.2967741935483871
다이아몬드 4,병렬 이분 탐색,47,13,34,0.2765957446808511
다이아몬드 4,아호-코라식,29,8,21,0.27586206896551724
다이아몬드 4,양방향 탐색,11,3,8,0.2727272727272727
다이아몬드 4,선분 교차 판정,179,46,133,0.2569832402234637
다이아몬드 4,평면 그래프,12,3,9,0.25
다이아몬드 4,볼록 껍질을 이용한 최적화,134,31,103,0.23134328358208955
다이아몬드 4,센트로이드 분할,39,9,30,0.23076923076923078
다이아몬드 4,센트로이드,40,9,31,0.225
다이아몬드 4,수치해석,156,35,121,0.22435897435897437
다이아몬드 4,미적분학,149,32,117,0.21476510067114093
다이아몬드 4,오일러 경로,19,4,15,0.21052631578947367
다이아몬드 4,트리 동형 사상,11,2,9,0.18181818181818182
다이아몬드 4,베이즈 정리,6,1,5,0.16666666666666666
다이아몬드 4,통계학,3,0,3,0.0
다이아몬드 4,히르쉬버그,3,0,3,0.0
다이아몬드 5,그린 정리,1,1,0,1.0
다이아몬드 5,이산 제곱근,2,2,0,1.0
다이아몬드 5,함수 개형을 이용한 최적화,11,10,1,0.9090909090909091
다이아몬드 5,담금질 기법,241,195,46,0.8091286307053942
다이아몬드 5,사칙연산,3097,2360,737,0.7620277688085244
다이아몬드 5,큐,117,87,30,0.7435897435897436
다이아몬드 5,휴리스틱,333,245,88,0.7357357357357357
다이아몬드 5,피타고라스 정리,118,85,33,0.7203389830508474
다이아몬드 5,안정 결혼 문제,24,17,7,0.7083333333333334
다이아몬드 5,머지 소트 트리,119,84,35,0.7058823529411765
다이아몬드 5,z,36,25,11,0.6944444444444444
다이아몬드 5,구현,7679,5151,2528,0.6707904675087902
다이아몬드 5,최소 비용 최대 유량,250,160,90,0.64
다이아몬드 5,덱,247,151,96,0.611336032388664
다이아몬드 5,이산 로그,28,17,11,0.6071428571428571
다이아몬드 5,문자열,3274,1982,1292,0.6053756872327428
다이아몬드 5,해시를 사용한 집합과 맵,550,332,218,0.6036363636363636
다이아몬드 5,시뮬레이션,1118,674,444,0.6028622540250447
다이아몬드 5,최소 스패닝 트리,374,225,149,0.6016042780748663
다이아몬드 5,크누스 최적화,10,6,4,0.6
다이아몬드 5,오일러 지표 (χ=v-e+f),15,9,6,0.6
다이아몬드 5,백트래킹,846,506,340,0.5981087470449172
다이아몬드 5,두 포인터,617,361,256,0.5850891410048622
다이아몬드 5,플로이드–와샬,290,167,123,0.5758620689655173
다이아몬드 5,외판원 순회 문제,66,38,28,0.5757575757575758
다이아몬드 5,스플레이 트리,7,4,3,0.5714285714285714
다이아몬드 5,수학,12243,6909,5334,0.5643224699828473
다이아몬드 5,재귀,466,262,204,0.5622317596566524
다이아몬드 5,스택,742,417,325,0.5619946091644205
다이아몬드 5,순열 사이클 분할,86,48,38,0.5581395348837209
다이아몬드 5,유클리드 호제법,377,210,167,0.5570291777188329
다이아몬드 5,기댓값의 선형성,18,10,8,0.5555555555555556
다이아몬드 5,이분 매칭,846,467,379,0.5520094562647754
다이아몬드 5,정렬,3020,1653,1367,0.5473509933774835
다이아몬드 5,브루트포스 알고리즘,2999,1631,1368,0.5438479493164388
다이아몬드 5,트리를 사용한 집합과 맵,434,234,200,0.5391705069124424
다이아몬드 5,조합론,1015,539,476,0.5310344827586206
다이아몬드 5,3차원 기하학,68,36,32,0.5294117647058824
다이아몬드 5,슬라이딩 윈도우,226,118,108,0.5221238938053098
다이아몬드 5,퍼시스턴트 세그먼트 트리,50,26,24,0.52
다이아몬드 5,누적 합,1052,538,514,0.5114068441064639
다이아몬드 5,매내처,88,45,43,0.5113636363636364
다이아몬드 5,깊이 우선 탐색,1446,739,707,0.5110650069156293
다이아몬드 5,너비 우선 탐색,2092,1047,1045,0.5004780114722753
다이아몬드 5,오일러 경로 테크닉,230,115,115,0.5
다이아몬드 5,비트마스킹,1036,518,518,0.5
다이아몬드 5,페르마의 소정리,168,84,84,0.5
다이아몬드 5,픽의 정리,2,1,1,0.5
다이아몬드 5,로프,4,2,2,0.5
다이아몬드 5,계산 이론,2,1,1,0.5
다이아몬드 5,홀의 결혼 정리,2,1,1,0.5
다이아몬드 5,에라토스테네스의 체,698,348,350,0.498567335243553
다이아몬드 5,최소 공통 조상,399,197,202,0.49373433583959897
다이아몬드 5,그래프 탐색,3672,1806,1866,0.4918300653594771
다이아몬드 5,다이나믹 프로그래밍,7509,3663,3846,0.48781462245305635
다이아몬드 5,스프라그–그런디 정리,366,178,188,0.48633879781420764
다이아몬드 5,자료 구조,7480,3634,3846,0.4858288770053476
다이아몬드 5,그리디 알고리즘,3446,1673,1773,0.4854904236796286
다이아몬드 5,kmp,447,216,231,0.48322147651006714
다이아몬드 5,정규 표현식,69,33,36,0.4782608695652174
다이아몬드 5,분할 정복,800,382,418,0.4775
다이아몬드 5,제곱근 분할법,250,119,131,0.476
다이아몬드 5,접미사 배열과 lcp 배열,185,88,97,0.4756756756756757
다이아몬드 5,비트필드를 이용한 다이나믹 프로그래밍,507,241,266,0.47534516765285995
다이아몬드 5,게임 이론,796,377,419,0.47361809045226133
다이아몬드 5,매개 변수 탐색,531,251,280,0.4726930320150659
다이아몬드 5,세그먼트 트리,3184,1505,1679,0.4726758793969849
다이아몬드 5,트리에서의 다이나믹 프로그래밍,508,239,269,0.4704724409448819
다이아몬드 5,0-1 너비 우선 탐색,77,36,41,0.4675324675324675
다이아몬드 5,그래프 이론,6634,3095,3539,0.466536026529997
다이아몬드 5,오프라인 쿼리,917,426,491,0.46455834242093785
다이아몬드 5,트리,2085,964,1121,0.46235011990407676
다이아몬드 5,가장 긴 증가하는 부분 수열: o(n log n),239,110,129,0.4602510460251046
다이아몬드 5,우선순위 큐,998,459,539,0.45991983967935873
다이아몬드 5,파싱,394,181,213,0.4593908629441624
다이아몬드 5,비둘기집 원리,61,28,33,0.45901639344262296
다이아몬드 5,큰 수 연산,624,285,339,0.4567307692307692
다이아몬드 5,임의 정밀도,624,285,339,0.4567307692307692
다이아몬드 5,확률론,211,96,115,0.4549763033175355
다이아몬드 5,스위핑,629,286,343,0.4546899841017488
다이아몬드 5,오일러 경로,33,15,18,0.45454545454545453
다이아몬드 5,트라이,336,152,184,0.4523809523809524
다이아몬드 5,최대 유량,1211,547,664,0.4516928158546656
다이아몬드 5,구성적,716,322,394,0.44972067039106145
다이아몬드 5,단절점과 단절선,69,31,38,0.4492753623188406
다이아몬드 5,라빈–카프,90,40,50,0.4444444444444444
다이아몬드 5,오프라인 동적 연결성 판정,18,8,10,0.4444444444444444
다이아몬드 5,분리 집합,870,386,484,0.4436781609195402
다이아몬드 5,정수론,3344,1482,1862,0.4431818181818182
다이아몬드 5,모듈로 곱셈 역원,217,96,121,0.4423963133640553
다이아몬드 5,소수 판정,1271,560,711,0.44059795436664045
다이아몬드 5,무작위화,273,120,153,0.43956043956043955
다이아몬드 5,다차원 세그먼트 트리,30,13,17,0.43333333333333335
다이아몬드 5,mo's,644,278,366,0.43167701863354035
다이아몬드 5,기하학,1933,834,1099,0.4314536989136058
다이아몬드 5,오목 다각형 내부의 점 판정,7,3,4,0.42857142857142855
다이아몬드 5,분할 정복을 이용한 거듭제곱,745,319,426,0.42818791946308726
다이아몬드 5,포함 배제의 원리,234,100,134,0.42735042735042733
다이아몬드 5,느리게 갱신되는 세그먼트 트리,1012,431,581,0.4258893280632411
다이아몬드 5,이분 탐색,2376,1011,1365,0.4255050505050505
다이아몬드 5,폴라드 로,259,110,149,0.4247104247104247
다이아몬드 5,물리학,33,14,19,0.42424242424242425
다이아몬드 5,애드 혹,1003,424,579,0.42273180458624127
다이아몬드 5,희소 배열,330,139,191,0.4212121212121212
다이아몬드 5,회전하는 캘리퍼스,151,63,88,0.41721854304635764
다이아몬드 5,배낭 문제,491,204,287,0.4154786150712831
다이아몬드 5,중간에서 만나기,333,138,195,0.4144144144144144
다이아몬드 5,좌표 압축,411,169,242,0.41119221411192214
다이아몬드 5,값,411,169,242,0.41119221411192214
다이아몬드 5,벌래캠프–매시,56,23,33,0.4107142857142857
다이아몬드 5,미적분학,142,58,84,0.4084507042253521
다이아몬드 5,컷 트리,5,2,3,0.4
다이아몬드 5,이분 그래프,25,10,15,0.4
다이아몬드 5,링크,5,2,3,0.4
다이아몬드 5,병렬 이분 탐색,10,4,6,0.4
다이아몬드 5,다익스트라,1043,411,632,0.3940556088207095
다이아몬드 5,덱을 이용한 다이나믹 프로그래밍,77,30,47,0.38961038961038963
다이아몬드 5,키타마사,13,5,8,0.38461538461538464
다이아몬드 5,위상 정렬,489,188,301,0.38445807770961143
다이아몬드 5,강한 연결 요소,754,289,465,0.383289124668435
다이아몬드 5,밀러–라빈 소수 판별법,366,140,226,0.3825136612021858
다이아몬드 5,벨만–포드,123,47,76,0.3821138211382114
다이아몬드 5,런타임 전의 전처리,222,83,139,0.3738738738738739
다이아몬드 5,2-sat,389,144,245,0.37017994858611825
다이아몬드 5,아호-코라식,74,27,47,0.36486486486486486
다이아몬드 5,히르쉬버그,22,8,14,0.36363636363636365
다이아몬드 5,작은 집합에서 큰 집합으로 합치는 테크닉,58,21,37,0.3620689655172414
다이아몬드 5,오일러 피 함수,158,57,101,0.36075949367088606
다이아몬드 5,비트 집합,76,27,49,0.35526315789473684
다이아몬드 5,볼록 껍질,599,212,387,0.35392320534223703
다이아몬드 5,분할 정복을 사용한 최적화,71,25,46,0.352112676056338
다이아몬드 5,선형대수학,169,59,110,0.34911242603550297
다이아몬드 5,고속 푸리에 변환,522,180,342,0.3448275862068966
다이아몬드 5,최소 외접원,58,20,38,0.3448275862068966
다이아몬드 5,많은 조건 분기,807,275,532,0.34076827757125155
다이아몬드 5,다각형의 넓이,60,20,40,0.3333333333333333
다이아몬드 5,heavy-light 분할,117,38,79,0.3247863247863248
다이아몬드 5,뤼카 정리,110,35,75,0.3181818181818182
다이아몬드 5,볼록 껍질을 이용한 최적화,197,61,136,0.3096446700507614
다이아몬드 5,선분 교차 판정,323,100,223,0.30959752321981426
다이아몬드 5,연결 리스트,95,29,66,0.30526315789473685
다이아몬드 5,양방향 탐색,10,3,7,0.3
다이아몬드 5,해싱,251,75,176,0.29880478087649404
다이아몬드 5,뫼비우스 반전 공식,82,24,58,0.2926829268292683
다이아몬드 5,볼록 다각형 내부의 점 판정,86,25,61,0.29069767441860467
다이아몬드 5,중국인의 나머지 정리,171,48,123,0.2807017543859649
다이아몬드 5,번사이드 보조정리,25,7,18,0.28
다이아몬드 5,통계학,11,3,8,0.2727272727272727
다이아몬드 5,확장 유클리드 호제법,115,31,84,0.26956521739130435
다이아몬드 5,최대 유량 최소 컷 정리,218,57,161,0.26146788990825687
다이아몬드 5,a*,4,1,3,0.25
다이아몬드 5,센트로이드,80,19,61,0.2375
다이아몬드 5,센트로이드 분할,80,19,61,0.2375
다이아몬드 5,삼분 탐색,133,26,107,0.19548872180451127
다이아몬드 5,가우스 소거법,66,12,54,0.18181818181818182
다이아몬드 5,수치해석,230,36,194,0.1565217391304348
다이아몬드 5,헝가리안,21,3,18,0.14285714285714285
다이아몬드 5,생성 함수,12,1,11,0.08333333333333333
다이아몬드 5,베이즈 정리,26,2,24,0.07692307692307693
다이아몬드 5,선인장,3,0,3,0.0
다이아몬드 5,커넥션 프로파일을 이용한 다이나믹 프로그래밍,4,0,4,0.0
다이아몬드 5,크누스 x,4,0,4,0.0
다이아몬드 5,🌎👨‍💻📄🎱📖🧪,1,0,1,0.0
다이아몬드 5,🧑‍💻,1,0,1,0.0
다이아몬드 5,춤추는 링크,4,0,4,0.0
다이아몬드 5,이중 연결 요소,10,0,10,0.0
다이아몬드 5,평면 그래프,6,0,6,0.0
다이아몬드 5,aliens 트릭,1,0,1,0.0
다이아몬드 5,🧵,1,0,1,0.0
다이아몬드 5,🏃🤔,1,0,1,0.0
루비 1,수치해석,2,2,0,1.0
루비 1,단조 큐를 이용한 최적화,1,1,0,1.0
루비 1,0-1 너비 우선 탐색,1,1,0,1.0
루비 1,커넥션 프로파일을 이용한 다이나믹 프로그래밍,1,1,0,1.0
루비 1,z,1,1,0,1.0
루비 1,비둘기집 원리,1,1,0,1.0
루비 1,슬라이딩 윈도우,2,2,0,1.0
루비 1,선형대수학,3,3,0,1.0
루비 1,외판원 순회 문제,1,1,0,1.0
루비 1,삼분 탐색,4,4,0,1.0
루비 1,최소 비용 최대 유량,5,5,0,1.0
루비 1,덱,2,2,0,1.0
루비 1,2-sat,1,1,0,1.0
루비 1,강한 연결 요소,1,1,0,1.0
루비 1,이분 매칭,3,3,0,1.0
루비 1,다각형의 넓이,1,1,0,1.0
루비 1,스플레이 트리,1,1,0,1.0
루비 1,중국인의 나머지 정리,2,2,0,1.0
루비 1,에라토스테네스의 체,9,8,1,0.8888888888888888
루비 1,홀의 결혼 정리,14,12,2,0.8571428571428571
루비 1,사칙연산,91,78,13,0.8571428571428571
루비 1,크누스 최적화,6,5,1,0.8333333333333334
루비 1,가장 긴 증가하는 부분 수열: o(n log n),6,5,1,0.8333333333333334
루비 1,최소 스패닝 트리,150,124,26,0.8266666666666667
루비 1,포함 배제의 원리,11,9,2,0.8181818181818182
루비 1,큰 수 연산,10,8,2,0.8
루비 1,임의 정밀도,10,8,2,0.8
루비 1,비트필드를 이용한 다이나믹 프로그래밍,22,17,5,0.7727272727272727
루비 1,피타고라스 정리,4,3,1,0.75
루비 1,최대 유량 최소 컷 정리,20,15,5,0.75
루비 1,분할 정복을 이용한 거듭제곱,11,8,3,0.7272727272727273
루비 1,최대 유량,42,30,12,0.7142857142857143
루비 1,kmp,7,5,2,0.7142857142857143
루비 1,그래프 이론,356,244,112,0.6853932584269663
루비 1,분리 집합,28,19,9,0.6785714285714286
루비 1,정렬,89,60,29,0.6741573033707865
루비 1,재귀,3,2,1,0.6666666666666666
루비 1,게임 이론,24,16,8,0.6666666666666666
루비 1,중간에서 만나기,9,6,3,0.6666666666666666
루비 1,뤼카 정리,9,6,3,0.6666666666666666
루비 1,스프라그–그런디 정리,15,10,5,0.6666666666666666
루비 1,mo's,18,12,6,0.6666666666666666
루비 1,조합론,61,40,21,0.6557377049180327
루비 1,애드 혹,40,26,14,0.65
루비 1,플로이드–와샬,11,7,4,0.6363636363636364
루비 1,트라이,11,7,4,0.6363636363636364
루비 1,구현,224,141,83,0.6294642857142857
루비 1,다익스트라,48,30,18,0.625
루비 1,비트마스킹,84,52,32,0.6190476190476191
루비 1,수학,404,249,155,0.6163366336633663
루비 1,우선순위 큐,31,19,12,0.6129032258064516
루비 1,값,23,14,9,0.6086956521739131
루비 1,좌표 압축,23,14,9,0.6086956521739131
루비 1,위상 정렬,5,3,2,0.6
루비 1,오일러 경로 테크닉,7,4,3,0.5714285714285714
루비 1,그리디 알고리즘,110,62,48,0.5636363636363636
루비 1,확률론,16,9,7,0.5625
루비 1,누적 합,66,37,29,0.5606060606060606
루비 1,오프라인 쿼리,43,24,19,0.5581395348837209
루비 1,비트 집합,9,5,4,0.5555555555555556
루비 1,두 포인터,18,10,8,0.5555555555555556
루비 1,그래프 탐색,116,64,52,0.5517241379310345
루비 1,백트래킹,35,19,16,0.5428571428571428
루비 1,기하학,41,22,19,0.5365853658536586
루비 1,스위핑,31,16,15,0.5161290322580645
루비 1,다이나믹 프로그래밍,321,165,156,0.514018691588785
루비 1,브루트포스 알고리즘,51,26,25,0.5098039215686274
루비 1,3차원 기하학,2,1,1,0.5
루비 1,담금질 기법,6,3,3,0.5
루비 1,고속 푸리에 변환,24,12,12,0.5
루비 1,밀러–라빈 소수 판별법,2,1,1,0.5
루비 1,휴리스틱,6,3,3,0.5
루비 1,구성적,56,28,28,0.5
루비 1,깊이 우선 탐색,41,20,21,0.4878048780487805
루비 1,시뮬레이션,35,17,18,0.4857142857142857
루비 1,너비 우선 탐색,50,24,26,0.48
루비 1,정수론,148,67,81,0.4527027027027027
루비 1,제곱근 분할법,62,28,34,0.45161290322580644
루비 1,스택,26,11,15,0.4230769230769231
루비 1,해시를 사용한 집합과 맵,26,11,15,0.4230769230769231
루비 1,유클리드 호제법,17,7,10,0.4117647058823529
루비 1,소수 판정,39,16,23,0.41025641025641024
루비 1,페르마의 소정리,20,8,12,0.4
루비 1,배낭 문제,20,8,12,0.4
루비 1,자료 구조,412,160,252,0.3883495145631068
루비 1,센트로이드 분할,26,10,16,0.38461538461538464
루비 1,많은 조건 분기,26,10,16,0.38461538461538464
루비 1,트리에서의 다이나믹 프로그래밍,21,8,13,0.38095238095238093
루비 1,트리,185,64,121,0.34594594594594597
루비 1,세그먼트 트리,272,92,180,0.3382352941176471
루비 1,문자열,95,32,63,0.3368421052631579
루비 1,센트로이드,24,8,16,0.3333333333333333
루비 1,오일러 지표 (χ=v-e+f),3,1,2,0.3333333333333333
루비 1,이분 그래프,3,1,2,0.3333333333333333
루비 1,평면 그래프,6,2,4,0.3333333333333333
루비 1,해싱,90,29,61,0.32222222222222224
루비 1,매개 변수 탐색,19,6,13,0.3157894736842105
루비 1,느리게 갱신되는 세그먼트 트리,38,12,26,0.3157894736842105
루비 1,트리를 사용한 집합과 맵,33,10,23,0.30303030303030304
루비 1,기댓값의 선형성,7,2,5,0.2857142857142857
루비 1,이분 탐색,117,31,86,0.26495726495726496
루비 1,분할 정복,87,23,64,0.26436781609195403
루비 1,파싱,4,1,3,0.25
루비 1,링크,12,3,9,0.25
루비 1,컷 트리,12,3,9,0.25
루비 1,희소 배열,66,16,50,0.24242424242424243
루비 1,최소 공통 조상,42,10,32,0.23809523809523808
루비 1,다차원 세그먼트 트리,9,2,7,0.2222222222222222
루비 1,볼록 껍질을 이용한 최적화,5,1,4,0.2
루비 1,단절점과 단절선,5,1,4,0.2
루비 1,aliens 트릭,20,4,16,0.2
루비 1,볼록 껍질,5,1,4,0.2
루비 1,이중 연결 요소,5,1,4,0.2
루비 1,라빈–카프,23,3,20,0.13043478260869565
루비 1,무작위화,16,2,14,0.125
루비 1,작은 집합에서 큰 집합으로 합치는 테크닉,16,2,14,0.125
루비 1,접미사 배열과 lcp 배열,14,0,14,0.0
루비 1,퍼시스턴트 세그먼트 트리,12,0,12,0.0
루비 1,오일러 경로,8,0,8,0.0
루비 1,분할 정복을 사용한 최적화,11,0,11,0.0
루비 1,런타임 전의 전처리,15,0,15,0.0
루비 2,확장 유클리드 호제법,1,1,0,1.0
루비 2,mo's,4,4,0,1.0
루비 2,베이즈 정리,1,1,0,1.0
루비 2,크누스 최적화,2,2,0,1.0
루비 2,물리학,1,1,0,1.0
루비 2,스프라그–그런디 정리,1,1,0,1.0
루비 2,쌍대성,1,1,0,1.0
루비 2,확률론,6,6,0,1.0
루비 2,반평면 교집합,1,1,0,1.0
루비 2,가우스 소거법,1,1,0,1.0
루비 2,연결 리스트,1,1,0,1.0
루비 2,스플레이 트리,2,2,0,1.0
루비 2,위상 정렬,3,3,0,1.0
루비 2,키타마사,3,3,0,1.0
루비 2,회전하는 캘리퍼스,3,3,0,1.0
루비 2,기댓값의 선형성,1,1,0,1.0
루비 2,쌍대 그래프,1,1,0,1.0
루비 2,오프라인 동적 연결성 판정,1,1,0,1.0
루비 2,선형 계획법,1,1,0,1.0
루비 2,탑 트리,1,1,0,1.0
루비 2,이분 그래프,1,1,0,1.0
루비 2,큐,1,1,0,1.0
루비 2,다각형의 넓이,1,1,0,1.0
루비 2,유클리드 호제법,5,5,0,1.0
루비 2,오일러 피 함수,1,1,0,1.0
루비 2,포함 배제의 원리,4,4,0,1.0
루비 2,현 그래프,1,1,0,1.0
루비 2,벌래캠프–매시,5,5,0,1.0
루비 2,로프,1,1,0,1.0
루비 2,작은 집합에서 큰 집합으로 합치는 테크닉,1,1,0,1.0
루비 2,히르쉬버그,1,1,0,1.0
루비 2,최대 유량 최소 컷 정리,2,2,0,1.0
루비 2,최대 유량,5,5,0,1.0
루비 2,최소 비용 최대 유량,2,2,0,1.0
루비 2,비트필드를 이용한 다이나믹 프로그래밍,11,10,1,0.9090909090909091
루비 2,두 포인터,10,9,1,0.9
루비 2,런타임 전의 전처리,9,8,1,0.8888888888888888
루비 2,해시를 사용한 집합과 맵,8,7,1,0.875
루비 2,삼분 탐색,7,6,1,0.8571428571428571
루비 2,정렬,116,98,18,0.8448275862068966
루비 2,가장 긴 증가하는 부분 수열: o(n log n),6,5,1,0.8333333333333334
루비 2,이분 매칭,6,5,1,0.8333333333333334
루비 2,게임 이론,16,13,3,0.8125
루비 2,사칙연산,31,25,6,0.8064516129032258
루비 2,비트마스킹,33,25,8,0.7575757575757576
루비 2,무작위화,8,6,2,0.75
루비 2,볼록 껍질,8,6,2,0.75
루비 2,폴라드 로,8,6,2,0.75
루비 2,배낭 문제,18,13,5,0.7222222222222222
루비 2,정수론,49,33,16,0.673469387755102
루비 2,슬라이딩 윈도우,9,6,3,0.6666666666666666
루비 2,페르마의 소정리,3,2,1,0.6666666666666666
루비 2,강한 연결 요소,3,2,1,0.6666666666666666
루비 2,비둘기집 원리,3,2,1,0.6666666666666666
루비 2,재귀,12,8,4,0.6666666666666666
루비 2,분할 정복을 이용한 거듭제곱,11,7,4,0.6363636363636364
루비 2,누적 합,48,29,19,0.6041666666666666
루비 2,볼록 껍질을 이용한 최적화,7,4,3,0.5714285714285714
루비 2,우선순위 큐,21,12,9,0.5714285714285714
루비 2,순열 사이클 분할,7,4,3,0.5714285714285714
루비 2,소수 판정,21,12,9,0.5714285714285714
루비 2,고속 푸리에 변환,7,4,3,0.5714285714285714
루비 2,다이나믹 프로그래밍,241,133,108,0.5518672199170125
루비 2,오프라인 쿼리,20,11,9,0.55
루비 2,수학,286,157,129,0.548951048951049
루비 2,밀러–라빈 소수 판별법,13,7,6,0.5384615384615384
루비 2,이분 탐색,114,61,53,0.5350877192982456
루비 2,단조 큐를 이용한 최적화,15,8,7,0.5333333333333333
루비 2,다익스트라,17,9,8,0.5294117647058824
루비 2,구현,217,112,105,0.5161290322580645
루비 2,너비 우선 탐색,37,19,18,0.5135135135135135
루비 2,aliens 트릭,37,19,18,0.5135135135135135
루비 2,그리디 알고리즘,125,63,62,0.504
루비 2,heavy-light 분할,20,10,10,0.5
루비 2,2-sat,2,1,1,0.5
루비 2,볼록 다각형 내부의 점 판정,4,2,2,0.5
루비 2,일반적인 매칭,2,1,1,0.5
루비 2,머지 소트 트리,2,1,1,0.5
루비 2,구성적,43,21,22,0.4883720930232558
루비 2,문자열,74,36,38,0.4864864864864865
루비 2,스위핑,29,14,15,0.4827586206896552
루비 2,분리 집합,27,13,14,0.48148148148148145
루비 2,그래프 탐색,74,35,39,0.47297297297297297
루비 2,브루트포스 알고리즘,67,30,37,0.44776119402985076
루비 2,애드 혹,74,33,41,0.44594594594594594
루비 2,최소 스패닝 트리,36,16,20,0.4444444444444444
루비 2,그래프 이론,191,81,110,0.42408376963350786
루비 2,깊이 우선 탐색,38,16,22,0.42105263157894735
루비 2,분할 정복을 사용한 최적화,12,5,7,0.4166666666666667
루비 2,매개 변수 탐색,18,7,11,0.3888888888888889
루비 2,백트래킹,18,7,11,0.3888888888888889
루비 2,스택,32,12,20,0.375
루비 2,자료 구조,409,152,257,0.37163814180929094
루비 2,최소 공통 조상,11,4,7,0.36363636363636365
루비 2,트리,136,49,87,0.3602941176470588
루비 2,오일러 경로 테크닉,14,5,9,0.35714285714285715
루비 2,조합론,29,10,19,0.3448275862068966
루비 2,느리게 갱신되는 세그먼트 트리,105,36,69,0.34285714285714286
루비 2,기하학,113,38,75,0.336283185840708
루비 2,세그먼트 트리,275,92,183,0.33454545454545453
루비 2,트리에서의 다이나믹 프로그래밍,36,12,24,0.3333333333333333
루비 2,링크,12,4,8,0.3333333333333333
루비 2,컷 트리,12,4,8,0.3333333333333333
루비 2,해싱,6,2,4,0.3333333333333333
루비 2,분할 정복,54,17,37,0.3148148148148148
루비 2,단절점과 단절선,23,7,16,0.30434782608695654
루비 2,많은 조건 분기,61,17,44,0.2786885245901639
루비 2,선인장,11,3,8,0.2727272727272727
루비 2,값,37,9,28,0.24324324324324326
루비 2,좌표 압축,37,9,28,0.24324324324324326
루비 2,퍼시스턴트 세그먼트 트리,33,8,25,0.24242424242424243
루비 2,미적분학,17,4,13,0.23529411764705882
루비 2,선분 교차 판정,17,4,13,0.23529411764705882
루비 2,이중 연결 요소,17,4,13,0.23529411764705882
루비 2,희소 배열,13,3,10,0.23076923076923078
루비 2,델로네 삼각분할,9,2,7,0.2222222222222222
루비 2,트라이,14,3,11,0.21428571428571427
루비 2,제곱근 분할법,14,3,11,0.21428571428571427
루비 2,병렬 이분 탐색,25,5,20,0.2
루비 2,피타고라스 정리,27,5,22,0.18518518518518517
루비 2,평면 그래프,11,2,9,0.18181818181818182
루비 2,수치해석,11,2,9,0.18181818181818182
루비 2,시뮬레이션,75,12,63,0.16
루비 2,3차원 기하학,25,4,21,0.16
루비 2,파싱,13,2,11,0.15384615384615385
루비 2,센트로이드 분할,7,1,6,0.14285714285714285
루비 2,큰 수 연산,14,2,12,0.14285714285714285
루비 2,임의 정밀도,14,2,12,0.14285714285714285
루비 2,센트로이드,7,1,6,0.14285714285714285
루비 2,덱,70,10,60,0.14285714285714285
루비 2,중간에서 만나기,7,1,6,0.14285714285714285
루비 2,트리를 사용한 집합과 맵,70,9,61,0.12857142857142856
루비 2,휴리스틱,9,1,8,0.1111111111111111
루비 2,kmp,10,1,9,0.1
루비 2,오일러 지표 (χ=v-e+f),10,1,9,0.1
루비 2,접미사 배열과 lcp 배열,12,1,11,0.08333333333333333
루비 2,선형대수학,13,1,12,0.07692307692307693
루비 2,보로노이 다이어그램,7,0,7,0.0
루비 2,외판원 순회 문제,1,0,1,0.0
루비 2,덱을 이용한 다이나믹 프로그래밍,3,0,3,0.0
루비 2,에라토스테네스의 체,1,0,1,0.0
루비 2,그린 정리,2,0,2,0.0
루비 3,오일러 경로,3,3,0,1.0
루비 3,큐,5,5,0,1.0
루비 3,트라이,7,7,0,1.0
루비 3,계산 이론,1,1,0,1.0
루비 3,모듈로 곱셈 역원,3,3,0,1.0
루비 3,피타고라스 정리,6,6,0,1.0
루비 3,트리 동형 사상,1,1,0,1.0
루비 3,aliens 트릭,2,2,0,1.0
루비 3,스플레이 트리,1,1,0,1.0
루비 3,최소 비용 최대 유량,1,1,0,1.0
루비 3,물리학,2,2,0,1.0
루비 3,회문 트리,3,3,0,1.0
루비 3,휴리스틱,2,2,0,1.0
루비 3,제곱근 분할법,1,1,0,1.0
루비 3,삼분 탐색,2,2,0,1.0
루비 3,머지 소트 트리,1,1,0,1.0
루비 3,선분 교차 판정,1,1,0,1.0
루비 3,볼록 다각형 내부의 점 판정,2,2,0,1.0
루비 3,비트 집합,1,1,0,1.0
루비 3,기댓값의 선형성,1,1,0,1.0
루비 3,가우스 소거법,2,2,0,1.0
루비 3,분할 정복을 사용한 최적화,2,2,0,1.0
루비 3,퍼시스턴트 세그먼트 트리,3,3,0,1.0
루비 3,일반적인 매칭,1,1,0,1.0
루비 3,확장 유클리드 호제법,1,1,0,1.0
루비 3,최소 외접원,2,2,0,1.0
루비 3,이분 그래프,1,1,0,1.0
루비 3,볼록 껍질을 이용한 최적화,4,4,0,1.0
루비 3,작은 집합에서 큰 집합으로 합치는 테크닉,6,6,0,1.0
루비 3,슬라이딩 윈도우,14,13,1,0.9285714285714286
루비 3,해시를 사용한 집합과 맵,35,32,3,0.9142857142857143
루비 3,시뮬레이션,78,70,8,0.8974358974358975
루비 3,최소 스패닝 트리,17,15,2,0.8823529411764706
루비 3,좌표 압축,8,7,1,0.875
루비 3,값,8,7,1,0.875
루비 3,두 포인터,23,20,3,0.8695652173913043
루비 3,배낭 문제,7,6,1,0.8571428571428571
루비 3,사칙연산,119,102,17,0.8571428571428571
루비 3,깊이 우선 탐색,81,69,12,0.8518518518518519
루비 3,트리를 사용한 집합과 맵,19,16,3,0.8421052631578947
루비 3,누적 합,56,46,10,0.8214285714285714
루비 3,구현,439,355,84,0.8086560364464692
루비 3,브루트포스 알고리즘,151,122,29,0.8079470198675497
루비 3,런타임 전의 전처리,20,16,4,0.8
루비 3,가장 긴 증가하는 부분 수열: o(n log n),5,4,1,0.8
루비 3,포함 배제의 원리,10,8,2,0.8
루비 3,오일러 경로 테크닉,10,8,2,0.8
루비 3,정렬,142,113,29,0.795774647887324
루비 3,스위핑,28,22,6,0.7857142857142857
루비 3,그래프 탐색,213,166,47,0.7793427230046949
루비 3,다익스트라,66,51,15,0.7727272727272727
루비 3,오프라인 쿼리,22,17,5,0.7727272727272727
루비 3,문자열,184,139,45,0.7554347826086957
루비 3,매내처,4,3,1,0.75
루비 3,병렬 이분 탐색,4,3,1,0.75
루비 3,비둘기집 원리,4,3,1,0.75
루비 3,0-1 너비 우선 탐색,4,3,1,0.75
루비 3,mo's,4,3,1,0.75
루비 3,기하학,74,55,19,0.7432432432432432
루비 3,구성적,57,42,15,0.7368421052631579
루비 3,덱,15,11,4,0.7333333333333333
루비 3,그래프 이론,417,303,114,0.7266187050359713
루비 3,너비 우선 탐색,120,87,33,0.725
루비 3,수학,600,432,168,0.72
루비 3,느리게 갱신되는 세그먼트 트리,38,27,11,0.7105263157894737
루비 3,게임 이론,20,14,6,0.7
루비 3,자료 구조,347,240,107,0.69164265129683
루비 3,중간에서 만나기,16,11,5,0.6875
루비 3,우선순위 큐,49,33,16,0.673469387755102
루비 3,정수론,119,80,39,0.6722689075630253
루비 3,이분 매칭,9,6,3,0.6666666666666666
루비 3,스프라그–그런디 정리,6,4,2,0.6666666666666666
루비 3,스택,33,22,11,0.6666666666666666
루비 3,에라토스테네스의 체,15,10,5,0.6666666666666666
루비 3,홀의 결혼 정리,6,4,2,0.6666666666666666
루비 3,오일러 지표 (χ=v-e+f),3,2,1,0.6666666666666666
루비 3,다각형의 넓이,3,2,1,0.6666666666666666
루비 3,트리,113,75,38,0.6637168141592921
루비 3,애드 혹,98,65,33,0.6632653061224489
루비 3,분리 집합,68,45,23,0.6617647058823529
루비 3,비트마스킹,72,47,25,0.6527777777777778
루비 3,임의 정밀도,23,15,8,0.6521739130434783
루비 3,큰 수 연산,23,15,8,0.6521739130434783
루비 3,조합론,69,45,24,0.6521739130434783
루비 3,플로이드–와샬,37,24,13,0.6486486486486487
루비 3,그리디 알고리즘,195,126,69,0.6461538461538462
루비 3,세그먼트 트리,122,78,44,0.639344262295082
루비 3,kmp,16,10,6,0.625
루비 3,다이나믹 프로그래밍,294,183,111,0.6224489795918368
루비 3,트리에서의 다이나믹 프로그래밍,39,24,15,0.6153846153846154
루비 3,위상 정렬,31,19,12,0.6129032258064516
루비 3,소수 판정,40,23,17,0.575
루비 3,많은 조건 분기,47,27,20,0.574468085106383
루비 3,강한 연결 요소,28,16,12,0.5714285714285714
루비 3,최소 공통 조상,14,8,6,0.5714285714285714
루비 3,오프라인 동적 연결성 판정,7,4,3,0.5714285714285714
루비 3,매개 변수 탐색,23,13,10,0.5652173913043478
루비 3,이분 탐색,95,53,42,0.5578947368421052
루비 3,파싱,29,16,13,0.5517241379310345
루비 3,비트필드를 이용한 다이나믹 프로그래밍,26,14,12,0.5384615384615384
루비 3,최대 유량,15,8,7,0.5333333333333333
루비 3,분할 정복,45,24,21,0.5333333333333333
루비 3,분할 정복을 이용한 거듭제곱,19,10,9,0.5263157894736842
루비 3,유클리드 호제법,23,12,11,0.5217391304347826
루비 3,확률론,25,13,12,0.52
루비 3,백트래킹,59,30,29,0.5084745762711864
루비 3,덱을 이용한 다이나믹 프로그래밍,8,4,4,0.5
루비 3,중국인의 나머지 정리,2,1,1,0.5
루비 3,오일러 피 함수,2,1,1,0.5
루비 3,벨만–포드,10,5,5,0.5
루비 3,2-sat,8,4,4,0.5
루비 3,3차원 기하학,8,4,4,0.5
루비 3,순열 사이클 분할,2,1,1,0.5
루비 3,함수 개형을 이용한 최적화,2,1,1,0.5
루비 3,뤼카 정리,2,1,1,0.5
루비 3,재귀,27,13,14,0.48148148148148145
루비 3,볼록 껍질,15,7,8,0.4666666666666667
루비 3,희소 배열,13,6,7,0.46153846153846156
루비 3,미적분학,9,4,5,0.4444444444444444
루비 3,최대 유량 최소 컷 정리,7,3,4,0.42857142857142855
루비 3,해싱,7,3,4,0.42857142857142855
루비 3,외판원 순회 문제,5,2,3,0.4
루비 3,밀러–라빈 소수 판별법,8,3,5,0.375
루비 3,선형대수학,19,7,12,0.3684210526315789
루비 3,평면 그래프,11,4,7,0.36363636363636365
루비 3,안정 결혼 문제,3,1,2,0.3333333333333333
루비 3,z,4,1,3,0.25
루비 3,이중 연결 요소,4,1,3,0.25
루비 3,선인장,4,1,3,0.25
루비 3,무작위화,18,4,14,0.2222222222222222
루비 3,접미사 배열과 lcp 배열,8,1,7,0.125
루비 3,센트로이드 분할,4,0,4,0.0
루비 3,고속 푸리에 변환,4,0,4,0.0
루비 3,센트로이드,4,0,4,0.0
루비 4,트리 압축,2,2,0,1.0
루비 4,번사이드 보조정리,2,2,0,1.0
루비 4,외판원 순회 문제,1,1,0,1.0
루비 4,삼분 탐색,4,4,0,1.0
루비 4,뫼비우스 반전 공식,4,4,0,1.0
루비 4,최대 유량 최소 컷 정리,1,1,0,1.0
루비 4,라빈–카프,2,2,0,1.0
루비 4,선분 교차 판정,1,1,0,1.0
루비 4,벌래캠프–매시,2,2,0,1.0
루비 4,서큘레이션,1,1,0,1.0
루비 4,4차원 이상의 기하학,1,1,0,1.0
루비 4,쌍대성,6,6,0,1.0
루비 4,선형 계획법,6,6,0,1.0
루비 4,오일러 피 함수,5,5,0,1.0
루비 4,통계학,4,4,0,1.0
루비 4,탑 트리,6,6,0,1.0
루비 4,일반적인 매칭,1,1,0,1.0
루비 4,2-sat,1,1,0,1.0
루비 4,기댓값의 선형성,4,4,0,1.0
루비 4,뤼카 정리,2,2,0,1.0
루비 4,백트래킹,36,34,2,0.9444444444444444
루비 4,포함 배제의 원리,13,12,1,0.9230769230769231
루비 4,런타임 전의 전처리,24,22,2,0.9166666666666666
루비 4,플로이드–와샬,11,10,1,0.9090909090909091
루비 4,확률론,30,27,3,0.9
루비 4,순열 사이클 분할,9,8,1,0.8888888888888888
루비 4,큐,9,8,1,0.8888888888888888
루비 4,머지 소트 트리,8,7,1,0.875
루비 4,비트 집합,7,6,1,0.8571428571428571
루비 4,덱,7,6,1,0.8571428571428571
루비 4,조합론,101,85,16,0.8415841584158416
루비 4,해시를 사용한 집합과 맵,91,76,15,0.8351648351648352
루비 4,히르쉬버그,6,5,1,0.8333333333333334
루비 4,최대 유량,16,13,3,0.8125
루비 4,정규 표현식,5,4,1,0.8
루비 4,가우스 소거법,5,4,1,0.8
루비 4,페르마의 소정리,10,8,2,0.8
루비 4,값,20,16,4,0.8
루비 4,좌표 압축,20,16,4,0.8
루비 4,구현,914,725,189,0.7932166301969366
루비 4,사칙연산,258,204,54,0.7906976744186046
루비 4,시뮬레이션,156,122,34,0.782051282051282
루비 4,트리를 사용한 집합과 맵,59,46,13,0.7796610169491526
루비 4,배낭 문제,18,14,4,0.7777777777777778
루비 4,비트필드를 이용한 다이나믹 프로그래밍,22,17,5,0.7727272727272727
루비 4,트라이,13,10,3,0.7692307692307693
루비 4,문자열,449,345,104,0.7683741648106904
루비 4,스택,41,31,10,0.7560975609756098
루비 4,유클리드 호제법,44,33,11,0.75
루비 4,3차원 기하학,12,9,3,0.75
루비 4,폴라드 로,4,3,1,0.75
루비 4,최소 비용 최대 유량,4,3,1,0.75
루비 4,크누스 최적화,8,6,2,0.75
루비 4,브루트포스 알고리즘,374,280,94,0.7486631016042781
루비 4,파싱,58,42,16,0.7241379310344828
루비 4,선형대수학,14,10,4,0.7142857142857143
루비 4,밀러–라빈 소수 판별법,7,5,2,0.7142857142857143
루비 4,너비 우선 탐색,147,103,44,0.7006802721088435
루비 4,무작위화,10,7,3,0.7
루비 4,에라토스테네스의 체,55,38,17,0.6909090909090909
루비 4,소수 판정,99,67,32,0.6767676767676768
루비 4,정렬,301,201,100,0.6677740863787376
루비 4,연결 리스트,6,4,2,0.6666666666666666
루비 4,피타고라스 정리,27,18,9,0.6666666666666666
루비 4,평면 그래프,3,2,1,0.6666666666666666
루비 4,아호-코라식,3,2,1,0.6666666666666666
루비 4,수학,1392,923,469,0.6630747126436781
루비 4,mo's,26,17,9,0.6538461538461539
루비 4,이분 매칭,17,11,6,0.6470588235294118
루비 4,오프라인 쿼리,51,33,18,0.6470588235294118
루비 4,고속 푸리에 변환,90,58,32,0.6444444444444445
루비 4,재귀,70,45,25,0.6428571428571429
루비 4,임의 정밀도,50,32,18,0.64
루비 4,큰 수 연산,50,32,18,0.64
루비 4,다이나믹 프로그래밍,523,329,194,0.6290630975143403
루비 4,정수론,387,238,149,0.6149870801033591
루비 4,그리디 알고리즘,411,248,163,0.6034063260340633
루비 4,heavy-light 분할,35,21,14,0.6
루비 4,중간에서 만나기,30,18,12,0.6
루비 4,우선순위 큐,75,45,30,0.6
루비 4,확장 유클리드 호제법,5,3,2,0.6
루비 4,비트마스킹,104,62,42,0.5961538461538461
루비 4,트리에서의 다이나믹 프로그래밍,74,44,30,0.5945945945945946
루비 4,슬라이딩 윈도우,24,14,10,0.5833333333333334
루비 4,작은 집합에서 큰 집합으로 합치는 테크닉,19,11,8,0.5789473684210527
루비 4,단조 큐를 이용한 최적화,7,4,3,0.5714285714285714
루비 4,센트로이드 분할,14,8,6,0.5714285714285714
루비 4,많은 조건 분기,120,68,52,0.5666666666666667
루비 4,센트로이드,16,9,7,0.5625
루비 4,반평면 교집합,18,10,8,0.5555555555555556
루비 4,비둘기집 원리,20,11,9,0.55
루비 4,자료 구조,745,405,340,0.5436241610738255
루비 4,게임 이론,61,33,28,0.5409836065573771
루비 4,그래프 탐색,364,196,168,0.5384615384615384
루비 4,누적 합,176,94,82,0.5340909090909091
루비 4,최소 스패닝 트리,15,8,7,0.5333333333333333
루비 4,회전하는 캘리퍼스,15,8,7,0.5333333333333333
루비 4,볼록 껍질,21,11,10,0.5238095238095238
루비 4,기하학,186,97,89,0.521505376344086
루비 4,구성적,137,71,66,0.5182481751824818
루비 4,분할 정복을 이용한 거듭제곱,56,29,27,0.5178571428571429
루비 4,두 포인터,64,33,31,0.515625
루비 4,분할 정복,71,36,35,0.5070422535211268
루비 4,트리,354,179,175,0.5056497175141242
루비 4,쌍대 그래프,2,1,1,0.5
루비 4,회문 트리,4,2,2,0.5
루비 4,컷 트리,2,1,1,0.5
루비 4,이산 로그,6,3,3,0.5
루비 4,트리 동형 사상,2,1,1,0.5
루비 4,가장 긴 증가하는 부분 수열: o(n log n),14,7,7,0.5
루비 4,링크,2,1,1,0.5
루비 4,함수 개형을 이용한 최적화,24,12,12,0.5
루비 4,중국인의 나머지 정리,63,31,32,0.49206349206349204
루비 4,이분 탐색,250,123,127,0.492
루비 4,미적분학,13,6,7,0.46153846153846156
루비 4,kmp,39,18,21,0.46153846153846156
루비 4,그래프 이론,580,267,313,0.4603448275862069
루비 4,깊이 우선 탐색,160,73,87,0.45625
루비 4,스플레이 트리,33,15,18,0.45454545454545453
루비 4,모듈로 곱셈 역원,29,13,16,0.4482758620689655
루비 4,세그먼트 트리,360,161,199,0.44722222222222224
루비 4,aliens 트릭,18,8,10,0.4444444444444444
루비 4,분할 정복을 사용한 최적화,9,4,5,0.4444444444444444
루비 4,최소 공통 조상,79,35,44,0.4430379746835443
루비 4,병렬 이분 탐색,25,11,14,0.44
루비 4,애드 혹,203,88,115,0.43349753694581283
루비 4,생성 함수,7,3,4,0.42857142857142855
루비 4,제곱근 분할법,26,11,15,0.4230769230769231
루비 4,희소 배열,43,18,25,0.4186046511627907
루비 4,퍼시스턴트 세그먼트 트리,27,11,16,0.4074074074074074
루비 4,분리 집합,98,38,60,0.3877551020408163
루비 4,느리게 갱신되는 세그먼트 트리,120,46,74,0.38333333333333336
루비 4,오일러 경로 테크닉,62,22,40,0.3548387096774194
루비 4,벨만–포드,20,7,13,0.35
루비 4,스위핑,98,34,64,0.3469387755102041
루비 4,다익스트라,88,30,58,0.3409090909090909
루비 4,이분 그래프,3,1,2,0.3333333333333333
루비 4,오일러 경로,6,2,4,0.3333333333333333
루비 4,매내처,6,2,4,0.3333333333333333
루비 4,스프라그–그런디 정리,25,8,17,0.32
루비 4,위상 정렬,25,8,17,0.32
루비 4,볼록 다각형 내부의 점 판정,10,3,7,0.3
루비 4,매개 변수 탐색,61,18,43,0.29508196721311475
루비 4,단절점과 단절선,7,2,5,0.2857142857142857
루비 4,물리학,15,4,11,0.26666666666666666
루비 4,접미사 배열과 lcp 배열,20,5,15,0.25
루비 4,볼록 껍질을 이용한 최적화,44,11,33,0.25
루비 4,0-1 너비 우선 탐색,21,5,16,0.23809523809523808
루비 4,강한 연결 요소,14,3,11,0.21428571428571427
루비 4,해싱,52,11,41,0.21153846153846154
루비 4,이중 연결 요소,5,1,4,0.2
루비 4,이산 제곱근,5,1,4,0.2
루비 4,선인장,6,1,5,0.16666666666666666
루비 4,홀의 결혼 정리,7,1,6,0.14285714285714285
루비 4,보로노이 다이어그램,13,1,12,0.07692307692307693
루비 5,탑 트리,2,2,0,1.0
루비 5,스토어–바그너,2,2,0,1.0
루비 5,그린 정리,1,1,0,1.0
루비 5,베이즈 정리,1,1,0,1.0
루비 5,이산 제곱근,3,3,0,1.0
루비 5,쌍대성,4,4,0,1.0
루비 5,인터프리터,1,1,0,1.0
루비 5,헝가리안,4,4,0,1.0
루비 5,생성 함수,1,1,0,1.0
루비 5,서큘레이션,2,2,0,1.0
루비 5,번사이드 보조정리,1,1,0,1.0
루비 5,선형 계획법,4,4,0,1.0
루비 5,로프,5,5,0,1.0
루비 5,외판원 순회 문제,26,22,4,0.8461538461538461
루비 5,큐,13,11,2,0.8461538461538461
루비 5,일반적인 매칭,6,5,1,0.8333333333333334
루비 5,회전하는 캘리퍼스,6,5,1,0.8333333333333334
루비 5,담금질 기법,34,28,6,0.8235294117647058
루비 5,물리학,10,8,2,0.8
루비 5,순열 사이클 분할,9,7,2,0.7777777777777778
루비 5,사칙연산,1018,784,234,0.7701375245579568
루비 5,z,13,10,3,0.7692307692307693
루비 5,쌍대 그래프,4,3,1,0.75
루비 5,스프라그–그런디 정리,27,20,7,0.7407407407407407
루비 5,재귀,85,62,23,0.7294117647058823
루비 5,머지 소트 트리,36,26,10,0.7222222222222222
루비 5,시뮬레이션,427,306,121,0.7166276346604216
루비 5,게임 이론,170,121,49,0.711764705882353
루비 5,모듈로 곱셈 역원,27,19,8,0.7037037037037037
루비 5,구현,2527,1770,757,0.700435298773249
루비 5,오일러 경로,10,7,3,0.7
루비 5,런타임 전의 전처리,121,83,38,0.6859504132231405
루비 5,페르마의 소정리,25,17,8,0.68
루비 5,비트마스킹,375,254,121,0.6773333333333333
루비 5,비트필드를 이용한 다이나믹 프로그래밍,86,58,28,0.6744186046511628
루비 5,브루트포스 알고리즘,953,638,315,0.6694648478488983
루비 5,현 그래프,3,2,1,0.6666666666666666
루비 5,크누스 최적화,3,2,1,0.6666666666666666
루비 5,너비 우선 탐색,571,379,192,0.6637478108581436
루비 5,고속 푸리에 변환,66,43,23,0.6515151515151515
루비 5,가장 긴 증가하는 부분 수열: o(n log n),60,39,21,0.65
루비 5,조합론,278,179,99,0.6438848920863309
루비 5,그래프 탐색,1130,722,408,0.6389380530973451
루비 5,중간에서 만나기,90,57,33,0.6333333333333333
루비 5,문자열,990,627,363,0.6333333333333333
루비 5,다익스트라,355,224,131,0.6309859154929578
루비 5,최소 공통 조상,173,109,64,0.630057803468208
루비 5,수학,3675,2315,1360,0.6299319727891156
루비 5,정렬,932,586,346,0.628755364806867
루비 5,백트래킹,327,205,122,0.6269113149847095
루비 5,연결 리스트,16,10,6,0.625
루비 5,선인장,24,15,9,0.625
루비 5,트리를 사용한 집합과 맵,217,135,82,0.6221198156682027
루비 5,트라이,95,59,36,0.6210526315789474
루비 5,깊이 우선 탐색,536,332,204,0.6194029850746269
루비 5,유클리드 호제법,123,76,47,0.6178861788617886
루비 5,에라토스테네스의 체,115,71,44,0.6173913043478261
루비 5,해시를 사용한 집합과 맵,309,190,119,0.6148867313915858
루비 5,오일러 피 함수,64,39,25,0.609375
루비 5,스택,233,141,92,0.6051502145922747
루비 5,함수 개형을 이용한 최적화,53,32,21,0.6037735849056604
루비 5,3차원 기하학,30,18,12,0.6
루비 5,휴리스틱,70,42,28,0.6
루비 5,아호-코라식,5,3,2,0.6
루비 5,정규 표현식,5,3,2,0.6
루비 5,다각형의 넓이,15,9,6,0.6
루비 5,무작위화,80,47,33,0.5875
루비 5,최대 유량 최소 컷 정리,75,44,31,0.5866666666666667
루비 5,회문 트리,19,11,8,0.5789473684210527
루비 5,그래프 이론,2160,1248,912,0.5777777777777777
루비 5,비둘기집 원리,33,19,14,0.5757575757575758
루비 5,위상 정렬,63,36,27,0.5714285714285714
루비 5,크누스 x,7,4,3,0.5714285714285714
루비 5,춤추는 링크,7,4,3,0.5714285714285714
루비 5,파싱,151,86,65,0.5695364238410596
루비 5,스플레이 트리,65,37,28,0.5692307692307692
루비 5,가우스 소거법,30,17,13,0.5666666666666667
루비 5,최소 스패닝 트리,157,88,69,0.5605095541401274
루비 5,우선순위 큐,339,190,149,0.56047197640118
루비 5,선형대수학,50,28,22,0.56
루비 5,포함 배제의 원리,68,38,30,0.5588235294117647
루비 5,홀의 결혼 정리,18,10,8,0.5555555555555556
루비 5,두 포인터,315,173,142,0.5492063492063493
루비 5,다이나믹 프로그래밍,2090,1145,945,0.5478468899521531
루비 5,피타고라스 정리,44,24,20,0.5454545454545454
루비 5,누적 합,556,303,253,0.5449640287769785
루비 5,소수 판정,219,118,101,0.5388127853881278
루비 5,분할 정복을 이용한 거듭제곱,149,80,69,0.5369127516778524
루비 5,자료 구조,3191,1705,1486,0.5343152616734566
루비 5,플로이드–와샬,45,24,21,0.5333333333333333
루비 5,매내처,45,24,21,0.5333333333333333
루비 5,비트 집합,17,9,8,0.5294117647058824
루비 5,heavy-light 분할,53,28,25,0.5283018867924528
루비 5,정수론,911,481,430,0.5279912184412733
루비 5,큰 수 연산,152,80,72,0.5263157894736842
루비 5,임의 정밀도,152,80,72,0.5263157894736842
루비 5,mo's,154,81,73,0.525974025974026
루비 5,2-sat,46,24,22,0.5217391304347826
루비 5,그리디 알고리즘,1174,608,566,0.5178875638841567
루비 5,오프라인 쿼리,257,131,126,0.5097276264591439
루비 5,강한 연결 요소,112,57,55,0.5089285714285714
루비 5,트리에서의 다이나믹 프로그래밍,333,169,164,0.5075075075075075
루비 5,트리,1206,612,594,0.5074626865671642
루비 5,볼록 껍질을 이용한 최적화,171,86,85,0.5029239766081871
루비 5,세그먼트 트리,1659,833,826,0.5021097046413502
루비 5,보로노이 다이어그램,2,1,1,0.5
루비 5,컷 트리,10,5,5,0.5
루비 5,키타마사,2,1,1,0.5
루비 5,링크,10,5,5,0.5
루비 5,최소 비용 최대 유량,30,15,15,0.5
루비 5,분리 집합,363,178,185,0.4903581267217631
루비 5,이분 매칭,102,50,52,0.49019607843137253
루비 5,단절점과 단절선,47,23,24,0.48936170212765956
루비 5,제곱근 분할법,263,128,135,0.4866920152091255
루비 5,스위핑,342,165,177,0.4824561403508772
루비 5,0-1 너비 우선 탐색,19,9,10,0.47368421052631576
루비 5,이분 탐색,1151,539,612,0.46828844483058213
루비 5,배낭 문제,106,49,57,0.46226415094339623
루비 5,확률론,102,47,55,0.46078431372549017
루비 5,많은 조건 분기,376,172,204,0.4574468085106383
루비 5,중국인의 나머지 정리,33,15,18,0.45454545454545453
루비 5,구성적,350,159,191,0.4542857142857143
루비 5,벌래캠프–매시,20,9,11,0.45
루비 5,최대 유량,212,94,118,0.44339622641509435
루비 5,작은 집합에서 큰 집합으로 합치는 테크닉,105,46,59,0.4380952380952381
루비 5,애드 혹,603,264,339,0.43781094527363185
루비 5,매개 변수 탐색,251,106,145,0.42231075697211157
루비 5,이중 연결 요소,45,19,26,0.4222222222222222
루비 5,기하학,768,322,446,0.4192708333333333
루비 5,오프라인 동적 연결성 판정,24,10,14,0.4166666666666667
루비 5,뤼카 정리,29,12,17,0.41379310344827586
루비 5,라빈–카프,17,7,10,0.4117647058823529
루비 5,삼분 탐색,62,25,37,0.4032258064516129
루비 5,느리게 갱신되는 세그먼트 트리,427,170,257,0.3981264637002342
루비 5,병렬 이분 탐색,151,60,91,0.3973509933774834
루비 5,슬라이딩 윈도우,49,19,30,0.3877551020408163
루비 5,kmp,139,53,86,0.381294964028777
루비 5,접미사 배열과 lcp 배열,63,24,39,0.38095238095238093
루비 5,벨만–포드,29,11,18,0.3793103448275862
루비 5,분할 정복,331,123,208,0.3716012084592145
루비 5,값,184,68,116,0.3695652173913043
루비 5,좌표 압축,184,68,116,0.3695652173913043
루비 5,오목 다각형 내부의 점 판정,11,4,7,0.36363636363636365
루비 5,분할 정복을 사용한 최적화,28,10,18,0.35714285714285715
루비 5,오일러 경로 테크닉,147,52,95,0.35374149659863946
루비 5,덱,40,14,26,0.35
루비 5,해싱,143,50,93,0.34965034965034963
루비 5,도미네이터 트리,26,9,17,0.34615384615384615
루비 5,선분 교차 판정,84,29,55,0.34523809523809523
루비 5,수치해석,32,11,21,0.34375
루비 5,센트로이드,47,16,31,0.3404255319148936
루비 5,커넥션 프로파일을 이용한 다이나믹 프로그래밍,15,5,10,0.3333333333333333
루비 5,aliens 트릭,74,23,51,0.3108108108108108
루비 5,기댓값의 선형성,29,9,20,0.3103448275862069
루비 5,희소 배열,148,45,103,0.30405405405405406
루비 5,볼록 다각형 내부의 점 판정,53,16,37,0.3018867924528302
루비 5,퍼시스턴트 세그먼트 트리,106,31,75,0.29245283018867924
루비 5,확장 유클리드 호제법,28,8,20,0.2857142857142857
루비 5,트리 동형 사상,35,10,25,0.2857142857142857
루비 5,센트로이드 분할,42,12,30,0.2857142857142857
루비 5,미적분학,74,21,53,0.28378378378378377
루비 5,평면 그래프,41,11,30,0.2682926829268293
루비 5,접미사 트리,4,1,3,0.25
루비 5,히르쉬버그,49,12,37,0.24489795918367346
루비 5,볼록 껍질,177,43,134,0.24293785310734464
루비 5,오일러 지표 (χ=v-e+f),26,6,20,0.23076923076923078
루비 5,단조 큐를 이용한 최적화,26,6,20,0.23076923076923078
루비 5,밀러–라빈 소수 판별법,53,11,42,0.20754716981132076
루비 5,이분 그래프,25,5,20,0.2
루비 5,다차원 세그먼트 트리,31,6,25,0.1935483870967742
루비 5,반평면 교집합,62,11,51,0.1774193548387097
루비 5,이산 로그,18,3,15,0.16666666666666666
루비 5,안정 결혼 문제,7,1,6,0.14285714285714285
루비 5,폴라드 로,49,7,42,0.14285714285714285
루비 5,양방향 탐색,17,2,15,0.11764705882352941
루비 5,뫼비우스 반전 공식,75,6,69,0.08
루비 5,덱을 이용한 다이나믹 프로그래밍,4,0,4,0.0
루비 5,🧑‍💻,4,0,4,0.0
루비 5,🌎👨‍💻📄🎱📖🧪,4,0,4,0.0
루비 5,🧵,4,0,4,0.0
루비 5,🏃🤔,4,0,4,0.0
루비 5,트리 압축,2,0,2,0.0
마스터,트리 동형 사상,1,1,0,1.0
마스터,3차원 기하학,4,4,0,1.0
마스터,라빈–카프,8,8,0,1.0
마스터,아호-코라식,1,1,0,1.0
마스터,물리학,8,8,0,1.0
마스터,히르쉬버그,4,4,0,1.0
마스터,슬라이딩 윈도우,11,11,0,1.0
마스터,모듈로 곱셈 역원,8,8,0,1.0
마스터,뤼카 정리,1,1,0,1.0
마스터,춤추는 링크,1,1,0,1.0
마스터,생성 함수,1,1,0,1.0
마스터,반평면 교집합,1,1,0,1.0
마스터,피타고라스 정리,16,16,0,1.0
마스터,다차원 세그먼트 트리,6,6,0,1.0
마스터,큐,3,3,0,1.0
마스터,크누스 x,1,1,0,1.0
마스터,중간에서 만나기,18,18,0,1.0
마스터,미적분학,3,3,0,1.0
마스터,벨만–포드,1,1,0,1.0
마스터,벌래캠프–매시,1,1,0,1.0
마스터,오목 다각형 내부의 점 판정,1,1,0,1.0
마스터,정규 표현식,3,3,0,1.0
마스터,현 그래프,1,1,0,1.0
마스터,분할 정복을 사용한 최적화,9,9,0,1.0
마스터,0-1 너비 우선 탐색,2,2,0,1.0
마스터,런타임 전의 전처리,27,26,1,0.9629629629629629
마스터,확률론,33,31,2,0.9393939393939394
마스터,제곱근 분할법,12,11,1,0.9166666666666666
마스터,삼분 탐색,10,9,1,0.9
마스터,순열 사이클 분할,10,9,1,0.9
마스터,무작위화,9,8,1,0.8888888888888888
마스터,가장 긴 증가하는 부분 수열: o(n log n),14,12,2,0.8571428571428571
마스터,위상 정렬,21,18,3,0.8571428571428571
마스터,담금질 기법,20,17,3,0.85
마스터,홀의 결혼 정리,6,5,1,0.8333333333333334
마스터,헝가리안,12,10,2,0.8333333333333334
마스터,해시를 사용한 집합과 맵,70,58,12,0.8285714285714286
마스터,백트래킹,58,48,10,0.8275862068965517
마스터,사칙연산,349,288,61,0.8252148997134671
마스터,휴리스틱,28,23,5,0.8214285714285714
마스터,트라이,28,23,5,0.8214285714285714
마스터,브루트포스 알고리즘,292,239,53,0.8184931506849316
마스터,오프라인 동적 연결성 판정,11,9,2,0.8181818181818182
마스터,스택,44,36,8,0.8181818181818182
마스터,너비 우선 탐색,170,138,32,0.8117647058823529
마스터,구현,887,720,167,0.8117249154453213
마스터,그래프 탐색,353,284,69,0.8045325779036827
마스터,시뮬레이션,166,133,33,0.8012048192771084
마스터,깊이 우선 탐색,187,149,38,0.7967914438502673
마스터,누적 합,154,122,32,0.7922077922077922
마스터,고속 푸리에 변환,23,18,5,0.782608695652174
마스터,기댓값의 선형성,9,7,2,0.7777777777777778
마스터,정렬,284,218,66,0.7676056338028169
마스터,최소 비용 최대 유량,30,23,7,0.7666666666666667
마스터,재귀,30,23,7,0.7666666666666667
마스터,덱,17,13,4,0.7647058823529411
마스터,오일러 지표 (χ=v-e+f),4,3,1,0.75
마스터,게임 이론,35,26,9,0.7428571428571429
마스터,가우스 소거법,19,14,5,0.7368421052631579
마스터,수학,1333,971,362,0.7284321080270068
마스터,트리에서의 다이나믹 프로그래밍,91,66,25,0.7252747252747253
마스터,최소 스패닝 트리,40,29,11,0.725
마스터,최대 유량 최소 컷 정리,43,31,12,0.7209302325581395
마스터,조합론,151,108,43,0.7152317880794702
마스터,배낭 문제,28,20,8,0.7142857142857143
마스터,2-sat,7,5,2,0.7142857142857143
마스터,최소 외접원,7,5,2,0.7142857142857143
마스터,문자열,403,287,116,0.7121588089330024
마스터,비트마스킹,125,87,38,0.696
마스터,비트 집합,13,9,4,0.6923076923076923
마스터,병렬 이분 탐색,16,11,5,0.6875
마스터,그리디 알고리즘,393,269,124,0.6844783715012722
마스터,그래프 이론,723,494,229,0.6832641770401107
마스터,다이나믹 프로그래밍,751,511,240,0.6804260985352862
마스터,구성적,128,87,41,0.6796875
마스터,다익스트라,76,51,25,0.6710526315789473
마스터,기하학,235,157,78,0.6680851063829787
마스터,함수 개형을 이용한 최적화,18,12,6,0.6666666666666666
마스터,포함 배제의 원리,18,12,6,0.6666666666666666
마스터,플로이드–와샬,15,10,5,0.6666666666666666
마스터,볼록 다각형 내부의 점 판정,3,2,1,0.6666666666666666
마스터,많은 조건 분기,130,86,44,0.6615384615384615
마스터,분할 정복을 이용한 거듭제곱,41,27,14,0.6585365853658537
마스터,분리 집합,93,61,32,0.6559139784946236
마스터,애드 혹,184,120,64,0.6521739130434783
마스터,임의 정밀도,66,43,23,0.6515151515151515
마스터,큰 수 연산,66,43,23,0.6515151515151515
마스터,오일러 경로,17,11,6,0.6470588235294118
마스터,트리를 사용한 집합과 맵,56,36,20,0.6428571428571429
마스터,서큘레이션,14,9,5,0.6428571428571429
마스터,매트로이드,25,16,9,0.64
마스터,에라토스테네스의 체,33,21,12,0.6363636363636364
마스터,유클리드 호제법,63,40,23,0.6349206349206349
마스터,정수론,308,195,113,0.6331168831168831
마스터,선형대수학,38,24,14,0.631578947368421
마스터,파싱,43,27,16,0.627906976744186
마스터,스프라그–그런디 정리,8,5,3,0.625
마스터,비둘기집 원리,8,5,3,0.625
마스터,오일러 피 함수,16,10,6,0.625
마스터,폴라드 로,8,5,3,0.625
마스터,트리,382,238,144,0.6230366492146597
마스터,강한 연결 요소,34,21,13,0.6176470588235294
마스터,평면 그래프,13,8,5,0.6153846153846154
마스터,소수 판정,79,48,31,0.6075949367088608
마스터,최소 공통 조상,76,46,30,0.6052631578947368
마스터,머지 소트 트리,5,3,2,0.6
마스터,이분 매칭,60,36,24,0.6
마스터,덱을 이용한 다이나믹 프로그래밍,10,6,4,0.6
마스터,자료 구조,896,537,359,0.5993303571428571
마스터,볼록 껍질을 이용한 최적화,54,32,22,0.5925925925925926
마스터,오일러 경로 테크닉,44,26,18,0.5909090909090909
마스터,오프라인 쿼리,63,37,26,0.5873015873015873
마스터,값,31,18,13,0.5806451612903226
마스터,좌표 압축,31,18,13,0.5806451612903226
마스터,비트필드를 이용한 다이나믹 프로그래밍,47,27,20,0.574468085106383
마스터,밀러–라빈 소수 판별법,7,4,3,0.5714285714285714
마스터,최대 유량,172,98,74,0.5697674418604651
마스터,우선순위 큐,123,70,53,0.5691056910569106
마스터,스위핑,122,67,55,0.5491803278688525
마스터,일반적인 매칭,11,6,5,0.5454545454545454
마스터,작은 집합에서 큰 집합으로 합치는 테크닉,44,24,20,0.5454545454545454
마스터,heavy-light 분할,24,13,11,0.5416666666666666
마스터,중국인의 나머지 정리,13,7,6,0.5384615384615384
마스터,외판원 순회 문제,28,15,13,0.5357142857142857
마스터,세그먼트 트리,520,272,248,0.5230769230769231
마스터,희소 배열,45,23,22,0.5111111111111111
마스터,매개 변수 탐색,93,47,46,0.5053763440860215
마스터,연결 리스트,8,4,4,0.5
마스터,크누스 최적화,4,2,2,0.5
마스터,커넥션 프로파일을 이용한 다이나믹 프로그래밍,6,3,3,0.5
마스터,델로네 삼각분할,2,1,1,0.5
마스터,도미네이터 트리,2,1,1,0.5
마스터,kmp,24,12,12,0.5
마스터,선분 교차 판정,18,9,9,0.5
마스터,4차원 이상의 기하학,2,1,1,0.5
마스터,분할 정복,167,82,85,0.49101796407185627
마스터,이분 탐색,318,155,163,0.48742138364779874
마스터,해싱,61,29,32,0.47540983606557374
마스터,접미사 배열과 lcp 배열,43,20,23,0.46511627906976744
마스터,선형 계획법,11,5,6,0.45454545454545453
마스터,매내처,11,5,6,0.45454545454545453
마스터,쌍대성,11,5,6,0.45454545454545453
마스터,쌍대 그래프,9,4,5,0.4444444444444444
마스터,이분 그래프,18,8,10,0.4444444444444444
마스터,볼록 껍질,70,31,39,0.44285714285714284
마스터,페르마의 소정리,16,7,9,0.4375
마스터,회전하는 캘리퍼스,16,7,9,0.4375
마스터,두 포인터,115,50,65,0.43478260869565216
마스터,선인장,50,21,29,0.42
마스터,센트로이드,24,10,14,0.4166666666666667
마스터,z,5,2,3,0.4
마스터,mo's,5,2,3,0.4
마스터,다각형의 넓이,25,10,15,0.4
마스터,느리게 갱신되는 세그먼트 트리,196,77,119,0.39285714285714285
마스터,단절점과 단절선,18,7,11,0.3888888888888889
마스터,확장 유클리드 호제법,16,6,10,0.375
마스터,이중 연결 요소,33,12,21,0.36363636363636365
마스터,스플레이 트리,14,5,9,0.35714285714285715
마스터,센트로이드 분할,23,8,15,0.34782608695652173
마스터,탑 트리,9,3,6,0.3333333333333333
마스터,링크,25,7,18,0.28
마스터,컷 트리,25,7,18,0.28
마스터,aliens 트릭,79,19,60,0.24050632911392406
마스터,단조 큐를 이용한 최적화,66,13,53,0.19696969696969696
마스터,퍼시스턴트 세그먼트 트리,64,11,53,0.171875
마스터,통계학,20,3,17,0.15
마스터,트리 압축,10,1,9,0.1
마스터,뫼비우스 반전 공식,9,0,9,0.0
마스터,보로노이 다이어그램,1,0,1,0.0
마스터,수치해석,3,0,3,0.0
브론즈 1,단절점과 단절선,1,1,0,1.0
브론즈 1,확장 유클리드 호제법,3,3,0,1.0
브론즈 1,heavy-light 분할,1,1,0,1.0
브론즈 1,볼록 껍질을 이용한 최적화,1,1,0,1.0
브론즈 1,기댓값의 선형성,1,1,0,1.0
브론즈 1,강한 연결 요소,2,2,0,1.0
브론즈 1,미적분학,3,3,0,1.0
브론즈 1,함수 개형을 이용한 최적화,2,2,0,1.0
브론즈 1,느리게 갱신되는 세그먼트 트리,1,1,0,1.0
브론즈 1,벨만–포드,5,4,1,0.8
브론즈 1,순열 사이클 분할,4,3,1,0.75
브론즈 1,확률론,8,6,2,0.75
브론즈 1,휴리스틱,91,63,28,0.6923076923076923
브론즈 1,정규 표현식,9,6,3,0.6666666666666666
브론즈 1,구현,73034,46619,26415,0.6383191390311361
브론즈 1,사칙연산,45880,28293,17587,0.6166739319965127
브론즈 1,기하학,2501,1480,1021,0.5917632946821272
브론즈 1,수학,66932,39547,27385,0.5908534034542521
브론즈 1,중국인의 나머지 정리,7,4,3,0.5714285714285714
브론즈 1,최소 공통 조상,11,6,5,0.5454545454545454
브론즈 1,문자열,9931,5234,4697,0.5270365522102507
브론즈 1,파싱,304,159,145,0.5230263157894737
브론즈 1,덱,233,120,113,0.5150214592274678
브론즈 1,큐,670,342,328,0.5104477611940299
브론즈 1,폴라드 로,8,4,4,0.5
브론즈 1,이분 매칭,14,7,7,0.5
브론즈 1,플로이드–와샬,72,36,36,0.5
브론즈 1,백트래킹,1053,511,542,0.4852801519468186
브론즈 1,분할 정복,248,118,130,0.47580645161290325
브론즈 1,위상 정렬,36,17,19,0.4722222222222222
브론즈 1,런타임 전의 전처리,24,11,13,0.4583333333333333
브론즈 1,브루트포스 알고리즘,5252,2400,2852,0.456968773800457
브론즈 1,깊이 우선 탐색,1612,734,878,0.45533498759305213
브론즈 1,유클리드 호제법,394,176,218,0.4467005076142132
브론즈 1,밀러–라빈 소수 판별법,9,4,5,0.4444444444444444
브론즈 1,피타고라스 정리,320,140,180,0.4375
브론즈 1,재귀,579,253,326,0.4369602763385147
브론즈 1,값,51,22,29,0.43137254901960786
브론즈 1,좌표 압축,51,22,29,0.43137254901960786
브론즈 1,그리디 알고리즘,3356,1440,1916,0.42908224076281287
브론즈 1,정렬,4479,1908,2571,0.42598794373744137
브론즈 1,게임 이론,141,60,81,0.425531914893617
브론즈 1,오일러 지표 (χ=v-e+f),12,5,7,0.4166666666666667
브론즈 1,너비 우선 탐색,2630,1088,1542,0.41368821292775665
브론즈 1,스택,2087,860,1227,0.4120747484427408
브론즈 1,정수론,2223,909,1314,0.4089068825910931
브론즈 1,그래프 탐색,2911,1186,1725,0.40742013053933357
브론즈 1,시뮬레이션,1210,488,722,0.4033057851239669
브론즈 1,그래프 이론,3235,1303,1932,0.40278207109737246
브론즈 1,비트마스킹,179,71,108,0.39664804469273746
브론즈 1,자료 구조,4693,1857,2836,0.39569571702535694
브론즈 1,조합론,463,182,281,0.3930885529157667
브론즈 1,다이나믹 프로그래밍,3791,1479,2312,0.3901345291479821
브론즈 1,트리,204,79,125,0.3872549019607843
브론즈 1,소수 판정,1396,526,870,0.37679083094555876
브론즈 1,임의 정밀도,1209,449,760,0.37138130686517784
브론즈 1,큰 수 연산,1209,449,760,0.37138130686517784
브론즈 1,해시를 사용한 집합과 맵,411,152,259,0.36982968369829683
브론즈 1,구성적,65,24,41,0.36923076923076925
브론즈 1,스위핑,38,14,24,0.3684210526315789
브론즈 1,비둘기집 원리,14,5,9,0.35714285714285715
브론즈 1,에라토스테네스의 체,1035,356,679,0.34396135265700484
브론즈 1,누적 합,448,150,298,0.33482142857142855
브론즈 1,물리학,3,1,2,0.3333333333333333
브론즈 1,외판원 순회 문제,3,1,2,0.3333333333333333
브론즈 1,스프라그–그런디 정리,3,1,2,0.3333333333333333
브론즈 1,최소 스패닝 트리,33,11,22,0.3333333333333333
브론즈 1,오일러 피 함수,3,1,2,0.3333333333333333
브론즈 1,우선순위 큐,549,180,369,0.32786885245901637
브론즈 1,두 포인터,416,133,283,0.31971153846153844
브론즈 1,세그먼트 트리,154,49,105,0.3181818181818182
브론즈 1,모듈로 곱셈 역원,16,5,11,0.3125
브론즈 1,애드 혹,153,47,106,0.30718954248366015
브론즈 1,트라이,30,9,21,0.3
브론즈 1,0-1 너비 우선 탐색,20,6,14,0.3
브론즈 1,슬라이딩 윈도우,138,41,97,0.2971014492753623
브론즈 1,다익스트라,294,84,210,0.2857142857142857
브론즈 1,가장 긴 증가하는 부분 수열: o(n log n),56,15,41,0.26785714285714285
브론즈 1,페르마의 소정리,15,4,11,0.26666666666666666
브론즈 1,연결 리스트,219,58,161,0.2648401826484018
브론즈 1,트리를 사용한 집합과 맵,142,37,105,0.2605633802816901
브론즈 1,이분 탐색,1436,374,1062,0.2604456824512535
브론즈 1,매개 변수 탐색,586,139,447,0.23720136518771331
브론즈 1,분할 정복을 이용한 거듭제곱,83,19,64,0.2289156626506024
브론즈 1,배낭 문제,155,34,121,0.21935483870967742
브론즈 1,많은 조건 분기,224,49,175,0.21875
브론즈 1,수치해석,121,24,97,0.19834710743801653
브론즈 1,분리 집합,162,32,130,0.19753086419753085
브론즈 1,다각형의 넓이,16,3,13,0.1875
브론즈 1,선분 교차 판정,65,12,53,0.18461538461538463
브론즈 1,희소 배열,24,4,20,0.16666666666666666
브론즈 1,선형대수학,26,4,22,0.15384615384615385
브론즈 1,kmp,25,3,22,0.12
브론즈 1,최대 유량,18,2,16,0.1111111111111111
브론즈 1,비트필드를 이용한 다이나믹 프로그래밍,21,1,20,0.047619047619047616
브론즈 1,작은 집합에서 큰 집합으로 합치는 테크닉,22,1,21,0.045454545454545456
브론즈 1,오프라인 쿼리,26,1,25,0.038461538461538464
브론즈 1,회전하는 캘리퍼스,2,0,2,0.0
브론즈 1,접미사 배열과 lcp 배열,3,0,3,0.0
브론즈 1,제곱근 분할법,1,0,1,0.0
브론즈 1,고속 푸리에 변환,1,0,1,0.0
브론즈 1,mo's,1,0,1,0.0
브론즈 1,라빈–카프,3,0,3,0.0
브론즈 1,헝가리안,6,0,6,0.0
브론즈 1,뤼카 정리,11,0,11,0.0
브론즈 1,중간에서 만나기,12,0,12,0.0
브론즈 1,트리에서의 다이나믹 프로그래밍,12,0,12,0.0
브론즈 1,🧵,1,0,1,0.0
브론즈 1,최소 외접원,7,0,7,0.0
브론즈 1,🏃🤔,1,0,1,0.0
브론즈 1,크누스 x,3,0,3,0.0
브론즈 1,🧑‍💻,1,0,1,0.0
브론즈 1,가우스 소거법,9,0,9,0.0
브론즈 1,해싱,3,0,3,0.0
브론즈 1,스플레이 트리,4,0,4,0.0
브론즈 1,춤추는 링크,3,0,3,0.0
브론즈 1,🌎👨‍💻📄🎱📖🧪,1,0,1,0.0
브론즈 1,볼록 껍질,2,0,2,0.0
브론즈 2,매내처,2,2,0,1.0
브론즈 2,분할 정복을 사용한 최적화,2,2,0,1.0
브론즈 2,수치해석,4,4,0,1.0
브론즈 2,런타임 전의 전처리,1,1,0,1.0
브론즈 2,오일러 지표 (χ=v-e+f),5,5,0,1.0
브론즈 2,모듈로 곱셈 역원,3,2,1,0.6666666666666666
브론즈 2,최소 공통 조상,6,4,2,0.6666666666666666
브론즈 2,구현,42061,26445,15616,0.6287297020993319
브론즈 2,기하학,1467,914,553,0.6230402181322426
브론즈 2,사칙연산,25660,15610,10050,0.6083398285268901
브론즈 2,수학,36942,21636,15306,0.5856748416436576
브론즈 2,트리를 사용한 집합과 맵,47,26,21,0.5531914893617021
브론즈 2,유클리드 호제법,159,86,73,0.5408805031446541
브론즈 2,오일러 피 함수,4,2,2,0.5
브론즈 2,플로이드–와샬,48,24,24,0.5
브론즈 2,페르마의 소정리,4,2,2,0.5
브론즈 2,벨만–포드,4,2,2,0.5
브론즈 2,선형대수학,14,7,7,0.5
브론즈 2,문자열,3355,1626,1729,0.4846497764530551
브론즈 2,임의 정밀도,478,230,248,0.4811715481171548
브론즈 2,큰 수 연산,478,230,248,0.4811715481171548
브론즈 2,분할 정복,155,73,82,0.47096774193548385
브론즈 2,피타고라스 정리,122,57,65,0.4672131147540984
브론즈 2,백트래킹,639,294,345,0.460093896713615
브론즈 2,덱,158,72,86,0.45569620253164556
브론즈 2,재귀,378,172,206,0.455026455026455
브론즈 2,파싱,175,78,97,0.44571428571428573
브론즈 2,해시를 사용한 집합과 맵,126,55,71,0.4365079365079365
브론즈 2,브루트포스 알고리즘,2246,966,1280,0.4300979519145147
브론즈 2,깊이 우선 탐색,909,385,524,0.4235423542354235
브론즈 2,큐,482,200,282,0.4149377593360996
브론즈 2,그리디 알고리즘,1593,660,933,0.4143126177024482
브론즈 2,너비 우선 탐색,1552,635,917,0.40914948453608246
브론즈 2,값,27,11,16,0.4074074074074074
브론즈 2,좌표 압축,27,11,16,0.4074074074074074
브론즈 2,트리,89,36,53,0.4044943820224719
브론즈 2,정렬,2165,873,1292,0.40323325635103924
브론즈 2,조합론,281,113,168,0.40213523131672596
브론즈 2,트라이,5,2,3,0.4
브론즈 2,그래프 탐색,1721,688,1033,0.399767576990122
브론즈 2,그래프 이론,1976,770,1206,0.3896761133603239
브론즈 2,자료 구조,2417,940,1477,0.38891187422424495
브론즈 2,다이나믹 프로그래밍,1756,681,1075,0.3878132118451025
브론즈 2,분할 정복을 이용한 거듭제곱,57,22,35,0.38596491228070173
브론즈 2,스택,1183,456,727,0.38546069315300086
브론즈 2,정규 표현식,16,6,10,0.375
브론즈 2,게임 이론,54,20,34,0.37037037037037035
브론즈 2,분리 집합,30,11,19,0.36666666666666664
브론즈 2,비트마스킹,118,42,76,0.3559322033898305
브론즈 2,우선순위 큐,206,73,133,0.35436893203883496
브론즈 2,시뮬레이션,773,269,504,0.34799482535575677
브론즈 2,정수론,1262,428,834,0.33914421553090335
브론즈 2,다각형의 넓이,3,1,2,0.3333333333333333
브론즈 2,세그먼트 트리,54,18,36,0.3333333333333333
브론즈 2,순열 사이클 분할,15,5,10,0.3333333333333333
브론즈 2,소수 판정,780,254,526,0.32564102564102565
브론즈 2,위상 정렬,41,12,29,0.2926829268292683
브론즈 2,스위핑,41,12,29,0.2926829268292683
브론즈 2,에라토스테네스의 체,641,187,454,0.2917316692667707
브론즈 2,애드 혹,87,25,62,0.28735632183908044
브론즈 2,연결 리스트,151,42,109,0.2781456953642384
브론즈 2,이분 탐색,643,178,465,0.27682737169517885
브론즈 2,매개 변수 탐색,244,67,177,0.27459016393442626
브론즈 2,다익스트라,198,53,145,0.2676767676767677
브론즈 2,비둘기집 원리,15,4,11,0.26666666666666666
브론즈 2,누적 합,257,65,192,0.2529182879377432
브론즈 2,트리에서의 다이나믹 프로그래밍,12,3,9,0.25
브론즈 2,배낭 문제,73,18,55,0.2465753424657534
브론즈 2,최소 스패닝 트리,33,8,25,0.24242424242424243
브론즈 2,두 포인터,259,55,204,0.21235521235521235
브론즈 2,슬라이딩 윈도우,67,14,53,0.208955223880597
브론즈 2,기댓값의 선형성,5,1,4,0.2
브론즈 2,많은 조건 분기,88,16,72,0.18181818181818182
브론즈 2,구성적,11,2,9,0.18181818181818182
브론즈 2,희소 배열,6,1,5,0.16666666666666666
브론즈 2,확률론,6,1,5,0.16666666666666666
브론즈 2,이분 매칭,20,3,17,0.15
브론즈 2,가장 긴 증가하는 부분 수열: o(n log n),27,4,23,0.14814814814814814
브론즈 2,중국인의 나머지 정리,32,3,29,0.09375
브론즈 2,kmp,27,2,25,0.07407407407407407
브론즈 2,🧑‍💻,1,0,1,0.0
브론즈 2,비트필드를 이용한 다이나믹 프로그래밍,1,0,1,0.0
브론즈 2,🌎👨‍💻📄🎱📖🧪,1,0,1,0.0
브론즈 2,🏃🤔,1,0,1,0.0
브론즈 2,🧵,1,0,1,0.0
브론즈 2,최대 유량,1,0,1,0.0
브론즈 2,밀러–라빈 소수 판별법,3,0,3,0.0
브론즈 2,3차원 기하학,1,0,1,0.0
브론즈 2,해싱,8,0,8,0.0
브론즈 2,물리학,1,0,1,0.0
브론즈 3,오일러 지표 (χ=v-e+f),2,2,0,1.0
브론즈 3,느리게 갱신되는 세그먼트 트리,1,1,0,1.0
브론즈 3,병렬 이분 탐색,2,2,0,1.0
브론즈 3,확률론,2,2,0,1.0
브론즈 3,기댓값의 선형성,1,1,0,1.0
브론즈 3,아호-코라식,1,1,0,1.0
브론즈 3,최소 공통 조상,6,5,1,0.8333333333333334
브론즈 3,이분 매칭,8,5,3,0.625
브론즈 3,구현,26590,16332,10258,0.6142158706280556
브론즈 3,사칙연산,15754,9467,6287,0.6009267487622191
브론즈 3,kmp,12,7,5,0.5833333333333334
브론즈 3,수학,23696,13309,10387,0.5616559756920999
브론즈 3,기하학,1087,588,499,0.5409383624655014
브론즈 3,최소 스패닝 트리,13,7,6,0.5384615384615384
브론즈 3,플로이드–와샬,19,10,9,0.5263157894736842
브론즈 3,게임 이론,23,12,11,0.5217391304347826
브론즈 3,파싱,130,67,63,0.5153846153846153
브론즈 3,3차원 기하학,2,1,1,0.5
브론즈 3,뤼카 정리,14,7,7,0.5
브론즈 3,외판원 순회 문제,6,3,3,0.5
브론즈 3,트라이,2,1,1,0.5
브론즈 3,백트래킹,381,187,194,0.49081364829396323
브론즈 3,유클리드 호제법,216,106,110,0.49074074074074076
브론즈 3,문자열,2754,1319,1435,0.47893972403776325
브론즈 3,피타고라스 정리,90,42,48,0.4666666666666667
브론즈 3,덱,96,44,52,0.4583333333333333
브론즈 3,큐,338,147,191,0.4349112426035503
브론즈 3,브루트포스 알고리즘,1930,838,1092,0.43419689119170984
브론즈 3,벨만–포드,7,3,4,0.42857142857142855
브론즈 3,분할 정복,201,86,115,0.42786069651741293
브론즈 3,깊이 우선 탐색,802,343,459,0.42768079800498754
브론즈 3,큰 수 연산,593,253,340,0.4266441821247892
브론즈 3,임의 정밀도,593,253,340,0.4266441821247892
브론즈 3,재귀,366,155,211,0.42349726775956287
브론즈 3,트리에서의 다이나믹 프로그래밍,12,5,7,0.4166666666666667
브론즈 3,스택,931,377,554,0.40494092373791624
브론즈 3,정렬,2214,885,1329,0.3997289972899729
브론즈 3,너비 우선 탐색,1272,501,771,0.3938679245283019
브론즈 3,해시를 사용한 집합과 맵,151,59,92,0.39072847682119205
브론즈 3,조합론,295,113,182,0.38305084745762713
브론즈 3,시뮬레이션,606,231,375,0.3811881188118812
브론즈 3,그리디 알고리즘,1949,731,1218,0.375064135454079
브론즈 3,트리,112,42,70,0.375
브론즈 3,자료 구조,1987,741,1246,0.3729240060392552
브론즈 3,비트마스킹,92,34,58,0.3695652173913043
브론즈 3,그래프 탐색,1460,538,922,0.3684931506849315
브론즈 3,다이나믹 프로그래밍,1738,640,1098,0.36823935558112775
브론즈 3,그래프 이론,1609,581,1028,0.3610938471100062
브론즈 3,정수론,1174,415,759,0.3534923339011925
브론즈 3,두 포인터,173,60,113,0.3468208092485549
브론즈 3,슬라이딩 윈도우,52,18,34,0.34615384615384615
브론즈 3,다익스트라,114,39,75,0.34210526315789475
브론즈 3,삼분 탐색,3,1,2,0.3333333333333333
브론즈 3,최대 유량,3,1,2,0.3333333333333333
브론즈 3,좌표 압축,25,8,17,0.32
브론즈 3,값,25,8,17,0.32
브론즈 3,애드 혹,34,10,24,0.29411764705882354
브론즈 3,연결 리스트,90,26,64,0.28888888888888886
브론즈 3,정규 표현식,35,10,25,0.2857142857142857
브론즈 3,소수 판정,687,196,491,0.2852983988355167
브론즈 3,세그먼트 트리,67,19,48,0.2835820895522388
브론즈 3,중국인의 나머지 정리,22,6,16,0.2727272727272727
브론즈 3,수치해석,15,4,11,0.26666666666666666
브론즈 3,이분 탐색,604,159,445,0.2632450331125828
브론즈 3,누적 합,199,52,147,0.2613065326633166
브론즈 3,가장 긴 증가하는 부분 수열: o(n log n),27,7,20,0.25925925925925924
브론즈 3,에라토스테네스의 체,522,134,388,0.2567049808429119
브론즈 3,트리를 사용한 집합과 맵,32,8,24,0.25
브론즈 3,배낭 문제,61,15,46,0.2459016393442623
브론즈 3,매개 변수 탐색,193,46,147,0.23834196891191708
브론즈 3,많은 조건 분기,96,22,74,0.22916666666666666
브론즈 3,위상 정렬,27,6,21,0.2222222222222222
브론즈 3,런타임 전의 전처리,32,7,25,0.21875
브론즈 3,우선순위 큐,240,51,189,0.2125
브론즈 3,모듈로 곱셈 역원,15,3,12,0.2
브론즈 3,선형대수학,17,3,14,0.17647058823529413
브론즈 3,스위핑,30,5,25,0.16666666666666666
브론즈 3,분할 정복을 이용한 거듭제곱,83,13,70,0.1566265060240964
브론즈 3,페르마의 소정리,14,2,12,0.14285714285714285
브론즈 3,미적분학,7,1,6,0.14285714285714285
브론즈 3,분리 집합,68,8,60,0.11764705882352941
브론즈 3,확장 유클리드 호제법,10,1,9,0.1
브론즈 3,구성적,41,3,38,0.07317073170731707
브론즈 3,순열 사이클 분할,2,0,2,0.0
브론즈 3,라빈–카프,2,0,2,0.0
브론즈 3,강한 연결 요소,4,0,4,0.0
브론즈 3,고속 푸리에 변환,1,0,1,0.0
브론즈 3,포함 배제의 원리,2,0,2,0.0
브론즈 3,접미사 배열과 lcp 배열,2,0,2,0.0
브론즈 3,해싱,4,0,4,0.0
브론즈 3,볼록 껍질,2,0,2,0.0
브론즈 3,물리학,1,0,1,0.0
브론즈 3,비트필드를 이용한 다이나믹 프로그래밍,1,0,1,0.0
브론즈 4,최소 공통 조상,2,2,0,1.0
브론즈 4,3차원 기하학,1,1,0,1.0
브론즈 4,볼록 껍질,1,1,0,1.0
브론즈 4,구현,16505,10316,6189,0.6250227203877613
브론즈 4,사칙연산,9942,6103,3839,0.6138603902635285
브론즈 4,수학,15703,8779,6924,0.5590651467872381
브론즈 4,파싱,82,45,37,0.5487804878048781
브론즈 4,백트래킹,215,115,100,0.5348837209302325
브론즈 4,기하학,853,440,413,0.5158264947245017
브론즈 4,큐,214,109,105,0.5093457943925234
브론즈 4,플로이드–와샬,4,2,2,0.5
브론즈 4,중국인의 나머지 정리,2,1,1,0.5
브론즈 4,최소 스패닝 트리,2,1,1,0.5
브론즈 4,덱,69,34,35,0.4927536231884058
브론즈 4,문자열,1988,978,1010,0.4919517102615694
브론즈 4,게임 이론,22,10,12,0.45454545454545453
브론즈 4,브루트포스 알고리즘,1439,651,788,0.45239749826268244
브론즈 4,분할 정복,71,32,39,0.4507042253521127
브론즈 4,깊이 우선 탐색,379,170,209,0.44854881266490765
브론즈 4,큰 수 연산,450,200,250,0.4444444444444444
브론즈 4,임의 정밀도,450,200,250,0.4444444444444444
브론즈 4,유클리드 호제법,155,65,90,0.41935483870967744
브론즈 4,정렬,1429,593,836,0.41497550734779565
브론즈 4,재귀,215,89,126,0.413953488372093
브론즈 4,너비 우선 탐색,557,230,327,0.4129263913824057
브론즈 4,스택,681,281,400,0.41262848751835535
브론즈 4,구성적,10,4,6,0.4
브론즈 4,정수론,856,337,519,0.39369158878504673
브론즈 4,피타고라스 정리,124,48,76,0.3870967741935484
브론즈 4,그래프 탐색,628,242,386,0.3853503184713376
브론즈 4,자료 구조,1405,535,870,0.3807829181494662
브론즈 4,그래프 이론,684,259,425,0.3786549707602339
브론즈 4,그리디 알고리즘,1487,556,931,0.37390719569603226
브론즈 4,소수 판정,521,194,327,0.3723608445297505
브론즈 4,시뮬레이션,367,134,233,0.3651226158038147
브론즈 4,런타임 전의 전처리,14,5,9,0.35714285714285715
브론즈 4,조합론,197,70,127,0.3553299492385787
브론즈 4,비트마스킹,48,17,31,0.3541666666666667
브론즈 4,다익스트라,32,11,21,0.34375
브론즈 4,선형대수학,12,4,8,0.3333333333333333
브론즈 4,위상 정렬,27,9,18,0.3333333333333333
브론즈 4,에라토스테네스의 체,373,124,249,0.3324396782841823
브론즈 4,많은 조건 분기,55,18,37,0.32727272727272727
브론즈 4,다이나믹 프로그래밍,1464,443,1021,0.3025956284153005
브론즈 4,배낭 문제,43,13,30,0.3023255813953488
브론즈 4,좌표 압축,10,3,7,0.3
브론즈 4,값,10,3,7,0.3
브론즈 4,이분 매칭,7,2,5,0.2857142857142857
브론즈 4,분리 집합,14,4,10,0.2857142857142857
브론즈 4,0-1 너비 우선 탐색,14,4,10,0.2857142857142857
브론즈 4,해시를 사용한 집합과 맵,88,25,63,0.2840909090909091
브론즈 4,애드 혹,33,9,24,0.2727272727272727
브론즈 4,두 포인터,147,40,107,0.272108843537415
브론즈 4,트리,60,16,44,0.26666666666666666
브론즈 4,분할 정복을 이용한 거듭제곱,31,8,23,0.25806451612903225
브론즈 4,트라이,12,3,9,0.25
브론즈 4,정규 표현식,16,4,12,0.25
브론즈 4,누적 합,106,26,80,0.24528301886792453
브론즈 4,우선순위 큐,147,35,112,0.23809523809523808
브론즈 4,연결 리스트,59,14,45,0.23728813559322035
브론즈 4,페르마의 소정리,17,4,13,0.23529411764705882
브론즈 4,모듈로 곱셈 역원,17,4,13,0.23529411764705882
브론즈 4,슬라이딩 윈도우,42,9,33,0.21428571428571427
브론즈 4,이분 탐색,420,85,335,0.20238095238095238
브론즈 4,비트 집합,5,1,4,0.2
브론즈 4,확률론,16,3,13,0.1875
브론즈 4,가장 긴 증가하는 부분 수열: o(n log n),11,2,9,0.18181818181818182
브론즈 4,느리게 갱신되는 세그먼트 트리,6,1,5,0.16666666666666666
브론즈 4,매개 변수 탐색,170,28,142,0.16470588235294117
브론즈 4,비둘기집 원리,13,2,11,0.15384615384615385
브론즈 4,세그먼트 트리,30,4,26,0.13333333333333333
브론즈 4,트리를 사용한 집합과 맵,65,7,58,0.1076923076923077
브론즈 4,최대 유량,10,1,9,0.1
브론즈 4,비트필드를 이용한 다이나믹 프로그래밍,12,1,11,0.08333333333333333
브론즈 4,고속 푸리에 변환,12,0,12,0.0
브론즈 4,선분 교차 판정,5,0,5,0.0
브론즈 4,확장 유클리드 호제법,2,0,2,0.0
브론즈 4,스프라그–그런디 정리,7,0,7,0.0
브론즈 4,스위핑,10,0,10,0.0
브론즈 4,kmp,1,0,1,0.0
브론즈 4,외판원 순회 문제,1,0,1,0.0
브론즈 4,포함 배제의 원리,1,0,1,0.0
브론즈 4,밀러–라빈 소수 판별법,2,0,2,0.0
브론즈 4,폴라드 로,2,0,2,0.0
브론즈 4,볼록 껍질을 이용한 최적화,3,0,3,0.0
브론즈 4,중간에서 만나기,2,0,2,0.0
브론즈 4,순열 사이클 분할,2,0,2,0.0
브론즈 5,오일러 경로,1,1,0,1.0
브론즈 5,가장 긴 증가하는 부분 수열: o(n log n),1,1,0,1.0
브론즈 5,게임 이론,5,5,0,1.0
브론즈 5,트리,10,7,3,0.7
브론즈 5,분할 정복,47,32,15,0.6808510638297872
브론즈 5,기하학,971,620,351,0.6385169927909372
브론즈 5,구현,26643,16513,10130,0.6197875614607965
브론즈 5,덱,13,8,5,0.6153846153846154
브론즈 5,사칙연산,17704,10602,7102,0.5988477180298237
브론즈 5,수학,22767,13142,9625,0.5772389862520314
브론즈 5,파싱,43,23,20,0.5348837209302325
브론즈 5,재귀,117,60,57,0.5128205128205128
브론즈 5,유클리드 호제법,79,40,39,0.5063291139240507
브론즈 5,런타임 전의 전처리,6,3,3,0.5
브론즈 5,외판원 순회 문제,2,1,1,0.5
브론즈 5,트리를 사용한 집합과 맵,4,2,2,0.5
브론즈 5,백트래킹,61,28,33,0.45901639344262296
브론즈 5,문자열,1396,631,765,0.4520057306590258
브론즈 5,브루트포스 알고리즘,726,317,409,0.4366391184573003
브론즈 5,시뮬레이션,153,66,87,0.43137254901960786
브론즈 5,해시를 사용한 집합과 맵,59,25,34,0.423728813559322
브론즈 5,정렬,798,332,466,0.41604010025062654
브론즈 5,구성적,5,2,3,0.4
브론즈 5,연결 리스트,25,10,15,0.4
브론즈 5,스택,335,126,209,0.3761194029850746
브론즈 5,큐,96,36,60,0.375
브론즈 5,피타고라스 정리,62,23,39,0.3709677419354839
브론즈 5,매개 변수 탐색,27,10,17,0.37037037037037035
브론즈 5,자료 구조,629,232,397,0.3688394276629571
브론즈 5,비트마스킹,38,14,24,0.3684210526315789
브론즈 5,우선순위 큐,33,12,21,0.36363636363636365
브론즈 5,임의 정밀도,510,175,335,0.3431372549019608
브론즈 5,큰 수 연산,510,175,335,0.3431372549019608
브론즈 5,정수론,413,141,272,0.3414043583535109
브론즈 5,너비 우선 탐색,171,58,113,0.3391812865497076
브론즈 5,그래프 탐색,186,62,124,0.3333333333333333
브론즈 5,조합론,147,49,98,0.3333333333333333
브론즈 5,깊이 우선 탐색,144,47,97,0.3263888888888889
브론즈 5,다이나믹 프로그래밍,724,234,490,0.32320441988950277
브론즈 5,그리디 알고리즘,711,229,482,0.32208157524613223
브론즈 5,에라토스테네스의 체,154,48,106,0.3116883116883117
브론즈 5,두 포인터,71,22,49,0.30985915492957744
브론즈 5,누적 합,59,18,41,0.3050847457627119
브론즈 5,그래프 이론,216,65,151,0.30092592592592593
브론즈 5,세그먼트 트리,20,6,14,0.3
브론즈 5,소수 판정,225,66,159,0.29333333333333333
브론즈 5,슬라이딩 윈도우,35,10,25,0.2857142857142857
브론즈 5,많은 조건 분기,32,9,23,0.28125
브론즈 5,이분 탐색,153,40,113,0.26143790849673204
브론즈 5,애드 혹,16,4,12,0.25
브론즈 5,물리학,4,1,3,0.25
브론즈 5,배낭 문제,4,1,3,0.25
브론즈 5,위상 정렬,9,2,7,0.2222222222222222
브론즈 5,분리 집합,18,3,15,0.16666666666666666
브론즈 5,kmp,16,1,15,0.0625
브론즈 5,다익스트라,23,1,22,0.043478260869565216
브론즈 5,분할 정복을 이용한 거듭제곱,26,1,25,0.038461538461538464
브론즈 5,벌래캠프–매시,2,0,2,0.0
브론즈 5,해싱,1,0,1,0.0
브론즈 5,확률론,1,0,1,0.0
브론즈 5,오일러 경로 테크닉,1,0,1,0.0
브론즈 5,선형대수학,3,0,3,0.0
브론즈 5,고속 푸리에 변환,1,0,1,0.0
브론즈 5,느리게 갱신되는 세그먼트 트리,1,0,1,0.0
브론즈 5,비둘기집 원리,1,0,1,0.0
브론즈 5,정규 표현식,1,0,1,0.0
브론즈 5,비트필드를 이용한 다이나믹 프로그래밍,2,0,2,0.0
실버 1,heavy-light 분할,1,1,0,1.0
실버 1,분할 정복을 사용한 최적화,1,1,0,1.0
실버 1,z,1,1,0,1.0
실버 1,볼록 다각형 내부의 점 판정,4,4,0,1.0
실버 1,이분 그래프,1,1,0,1.0
실버 1,양방향 탐색,1,1,0,1.0
실버 1,최소 비용 최대 유량,9,9,0,1.0
실버 1,번사이드 보조정리,2,2,0,1.0
실버 1,오일러 지표 (χ=v-e+f),48,42,6,0.875
실버 1,수치해석,4,3,1,0.75
실버 1,사칙연산,38400,26822,11578,0.6984895833333333
실버 1,휴리스틱,3,2,1,0.6666666666666666
실버 1,담금질 기법,3,2,1,0.6666666666666666
실버 1,구현,99821,63982,35839,0.6409673315234269
실버 1,피타고라스 정리,1479,898,581,0.6071670047329276
실버 1,기댓값의 선형성,10,6,4,0.6
실버 1,확률론,52,31,21,0.5961538461538461
실버 1,수학,97721,57951,39770,0.5930250406770295
실버 1,문자열,31652,18467,13185,0.5834386452672817
실버 1,큰 수 연산,3421,1968,1453,0.575270388775212
실버 1,임의 정밀도,3421,1968,1453,0.575270388775212
실버 1,조합론,3200,1836,1364,0.57375
실버 1,게임 이론,490,281,209,0.573469387755102
실버 1,기하학,6911,3963,2948,0.5734336564896542
실버 1,폴라드 로,7,4,3,0.5714285714285714
실버 1,큐,5573,3148,2425,0.5648663197559662
실버 1,백트래킹,10375,5781,4594,0.5572048192771084
실버 1,최대 유량,33,18,15,0.5454545454545454
실버 1,분할 정복,2489,1345,1144,0.5403776617115308
실버 1,재귀,5740,3062,2678,0.5334494773519164
실버 1,유클리드 호제법,3626,1909,1717,0.5264754550468836
실버 1,브루트포스 알고리즘,25577,13162,12415,0.5146029636001095
실버 1,a*,2,1,1,0.5
실버 1,최소 공통 조상,54,27,27,0.5
실버 1,가우스 소거법,2,1,1,0.5
실버 1,시뮬레이션,8588,4215,4373,0.4908011178388449
실버 1,스택,12341,5976,6365,0.48423952678064985
실버 1,해시를 사용한 집합과 맵,4086,1964,2122,0.48066568771414586
실버 1,그리디 알고리즘,18126,8623,9503,0.4757254772150502
실버 1,위상 정렬,406,193,213,0.4753694581280788
실버 1,정렬,33754,16037,17717,0.475114060555786
실버 1,깊이 우선 탐색,12072,5715,6357,0.47340954274353875
실버 1,순열 사이클 분할,83,39,44,0.46987951807228917
실버 1,파싱,2746,1290,1456,0.4697742170429716
실버 1,다이나믹 프로그래밍,27909,12945,14964,0.4638288724067505
실버 1,플로이드–와샬,974,448,526,0.459958932238193
실버 1,자료 구조,33704,15473,18231,0.4590849750771422
실버 1,덱,2623,1204,1419,0.45901639344262296
실버 1,정수론,17642,8069,9573,0.45737444734157123
실버 1,너비 우선 탐색,20553,9279,11274,0.4514669391329733
실버 1,그래프 탐색,24009,10486,13523,0.436752884335041
실버 1,모듈로 곱셈 역원,71,31,40,0.43661971830985913
실버 1,소수 판정,10588,4561,6027,0.4307706837929732
실버 1,그래프 이론,27974,12024,15950,0.4298276971473511
실버 1,최소 스패닝 트리,587,252,335,0.4293015332197615
실버 1,삼분 탐색,7,3,4,0.42857142857142855
실버 1,선형대수학,200,85,115,0.425
실버 1,트리를 사용한 집합과 맵,1115,472,643,0.4233183856502242
실버 1,런타임 전의 전처리,318,134,184,0.42138364779874216
실버 1,단절점과 단절선,19,8,11,0.42105263157894735
실버 1,비트 집합,12,5,7,0.4166666666666667
실버 1,강한 연결 요소,34,14,20,0.4117647058823529
실버 1,에라토스테네스의 체,7864,3221,4643,0.409587995930824
실버 1,트리,2150,870,1280,0.4046511627906977
실버 1,값,1381,555,826,0.40188269370021723
실버 1,좌표 압축,1381,555,826,0.40188269370021723
실버 1,머지 소트 트리,10,4,6,0.4
실버 1,함수 개형을 이용한 최적화,5,2,3,0.4
실버 1,구성적,272,108,164,0.39705882352941174
실버 1,연결 리스트,1137,449,688,0.39489885664028146
실버 1,비트마스킹,1837,719,1118,0.3913990201415351
실버 1,배낭 문제,1001,388,613,0.3876123876123876
실버 1,3차원 기하학,50,19,31,0.38
실버 1,볼록 껍질,51,19,32,0.37254901960784315
실버 1,페르마의 소정리,78,29,49,0.3717948717948718
실버 1,비트필드를 이용한 다이나믹 프로그래밍,149,54,95,0.3624161073825503
실버 1,우선순위 큐,3840,1384,2456,0.36041666666666666
실버 1,희소 배열,25,9,16,0.36
실버 1,정규 표현식,281,101,180,0.3594306049822064
실버 1,회전하는 캘리퍼스,17,6,11,0.35294117647058826
실버 1,가장 긴 증가하는 부분 수열: o(n log n),312,110,202,0.3525641025641026
실버 1,외판원 순회 문제,262,90,172,0.3435114503816794
실버 1,다익스트라,2851,979,1872,0.34338828481234657
실버 1,누적 합,2586,881,1705,0.34068058778035576
실버 1,많은 조건 분기,1220,408,812,0.3344262295081967
실버 1,확장 유클리드 호제법,12,4,8,0.3333333333333333
실버 1,중국인의 나머지 정리,159,53,106,0.3333333333333333
실버 1,슬라이딩 윈도우,770,256,514,0.33246753246753247
실버 1,두 포인터,3414,1133,2281,0.3318687756297598
실버 1,이분 탐색,10975,3610,7365,0.32892938496583146
실버 1,밀러–라빈 소수 판별법,52,17,35,0.3269230769230769
실버 1,0-1 너비 우선 탐색,334,109,225,0.3263473053892216
실버 1,애드 혹,834,271,563,0.3249400479616307
실버 1,트라이,196,62,134,0.3163265306122449
실버 1,비둘기집 원리,55,17,38,0.3090909090909091
실버 1,kmp,212,65,147,0.30660377358490565
실버 1,분할 정복을 이용한 거듭제곱,926,278,648,0.3002159827213823
실버 1,무작위화,17,5,12,0.29411764705882354
실버 1,매개 변수 탐색,4488,1313,3175,0.2925579322638146
실버 1,뤼카 정리,25,7,18,0.28
실버 1,트리에서의 다이나믹 프로그래밍,208,58,150,0.27884615384615385
실버 1,분리 집합,1101,307,794,0.27883742052679383
실버 1,벨만–포드,163,45,118,0.27607361963190186
실버 1,스프라그–그런디 정리,33,9,24,0.2727272727272727
실버 1,세그먼트 트리,606,162,444,0.26732673267326734
실버 1,느리게 갱신되는 세그먼트 트리,30,8,22,0.26666666666666666
실버 1,스위핑,275,71,204,0.2581818181818182
실버 1,오프라인 쿼리,12,3,9,0.25
실버 1,오일러 피 함수,29,7,22,0.2413793103448276
실버 1,미적분학,77,18,59,0.23376623376623376
실버 1,포함 배제의 원리,31,7,24,0.22580645161290322
실버 1,중간에서 만나기,126,28,98,0.2222222222222222
실버 1,오일러 경로,18,4,14,0.2222222222222222
실버 1,다각형의 넓이,68,15,53,0.22058823529411764
실버 1,고속 푸리에 변환,14,3,11,0.21428571428571427
실버 1,선분 교차 판정,83,17,66,0.20481927710843373
실버 1,물리학,36,7,29,0.19444444444444445
실버 1,라빈–카프,29,5,24,0.1724137931034483
실버 1,접미사 배열과 lcp 배열,30,5,25,0.16666666666666666
실버 1,이분 매칭,87,13,74,0.14942528735632185
실버 1,볼록 껍질을 이용한 최적화,7,1,6,0.14285714285714285
실버 1,매내처,53,7,46,0.1320754716981132
실버 1,이중 연결 요소,11,1,10,0.09090909090909091
실버 1,해싱,114,7,107,0.06140350877192982
실버 1,그린 정리,19,1,18,0.05263157894736842
실버 1,🧑‍💻,2,0,2,0.0
실버 1,🏃🤔,2,0,2,0.0
실버 1,mo's,5,0,5,0.0
실버 1,작은 집합에서 큰 집합으로 합치는 테크닉,2,0,2,0.0
실버 1,🌎👨‍💻📄🎱📖🧪,2,0,2,0.0
실버 1,회문 트리,2,0,2,0.0
실버 1,🧵,2,0,2,0.0
실버 1,병렬 이분 탐색,1,0,1,0.0
실버 1,히르쉬버그,1,0,1,0.0
실버 1,aliens 트릭,2,0,2,0.0
실버 1,아호-코라식,2,0,2,0.0
실버 1,선인장,11,0,11,0.0
실버 2,이중 연결 요소,1,1,0,1.0
실버 2,함수 개형을 이용한 최적화,1,1,0,1.0
실버 2,선인장,1,1,0,1.0
실버 2,오목 다각형 내부의 점 판정,1,1,0,1.0
실버 2,퍼시스턴트 세그먼트 트리,1,1,0,1.0
실버 2,담금질 기법,9,9,0,1.0
실버 2,단조 큐를 이용한 최적화,2,2,0,1.0
실버 2,크누스 최적화,1,1,0,1.0
실버 2,오일러 지표 (χ=v-e+f),49,49,0,1.0
실버 2,순열 사이클 분할,30,24,6,0.8
실버 2,스프라그–그런디 정리,8,6,2,0.75
실버 2,히르쉬버그,4,3,1,0.75
실버 2,heavy-light 분할,12,9,3,0.75
실버 2,오일러 경로,22,15,7,0.6818181818181818
실버 2,사칙연산,51226,34210,17016,0.667824932651388
실버 2,휴리스틱,15,10,5,0.6666666666666666
실버 2,덱을 이용한 다이나믹 프로그래밍,3,2,1,0.6666666666666666
실버 2,aliens 트릭,3,2,1,0.6666666666666666
실버 2,비트 집합,6,4,2,0.6666666666666666
실버 2,구현,115985,74311,41674,0.6406949174462215
실버 2,게임 이론,327,190,137,0.581039755351682
실버 2,수학,119666,68785,50881,0.5748082162017616
실버 2,문자열,34339,19585,14754,0.5703427589621131
실버 2,기하학,8858,5046,3812,0.5696545495597201
실버 2,피타고라스 정리,2100,1176,924,0.56
실버 2,머지 소트 트리,18,10,8,0.5555555555555556
실버 2,재귀,4909,2680,2229,0.5459360358525158
실버 2,큐,5410,2917,2493,0.5391866913123845
실버 2,분할 정복,2215,1193,1022,0.5386004514672686
실버 2,백트래킹,9134,4911,4223,0.5376614845631705
실버 2,조합론,3264,1720,1544,0.5269607843137255
실버 2,단절점과 단절선,19,10,9,0.5263157894736842
실버 2,유클리드 호제법,3275,1688,1587,0.5154198473282443
실버 2,임의 정밀도,4114,2096,2018,0.5094798249878464
실버 2,큰 수 연산,4114,2096,2018,0.5094798249878464
실버 2,플로이드–와샬,726,367,359,0.5055096418732782
실버 2,브루트포스 알고리즘,25915,13063,12852,0.5040710013505691
실버 2,다차원 세그먼트 트리,2,1,1,0.5
실버 2,회전하는 캘리퍼스,6,3,3,0.5
실버 2,키타마사,2,1,1,0.5
실버 2,병렬 이분 탐색,8,4,4,0.5
실버 2,최소 스패닝 트리,486,236,250,0.48559670781893005
실버 2,시뮬레이션,7749,3724,4025,0.48057813911472447
실버 2,이분 매칭,174,83,91,0.47701149425287354
실버 2,깊이 우선 탐색,10433,4956,5477,0.47503115115498895
실버 2,파싱,2235,1057,1178,0.47293064876957497
실버 2,확률론,36,17,19,0.4722222222222222
실버 2,오프라인 쿼리,32,15,17,0.46875
실버 2,덱,2362,1107,1255,0.4686706181202371
실버 2,그리디 알고리즘,16102,7446,8656,0.46242702769842253
실버 2,스택,12280,5678,6602,0.4623778501628665
실버 2,정렬,33290,15375,17915,0.4618504055271853
실버 2,해시를 사용한 집합과 맵,3674,1692,1982,0.46053347849755033
실버 2,다이나믹 프로그래밍,23587,10700,12887,0.4536397167931488
실버 2,너비 우선 탐색,17679,7934,9745,0.448781039651564
실버 2,자료 구조,31947,14232,17715,0.44548783923373086
실버 2,트리를 사용한 집합과 맵,847,374,473,0.44155844155844154
실버 2,그래프 탐색,20481,8943,11538,0.43664860114252235
실버 2,정수론,19690,8537,11153,0.4335703402742509
실버 2,그래프 이론,23847,10210,13637,0.4281460980416824
실버 2,트리,1883,789,1094,0.419012214551248
실버 2,위상 정렬,457,190,267,0.41575492341356673
실버 2,좌표 압축,1314,544,770,0.4140030441400304
실버 2,값,1314,544,770,0.4140030441400304
실버 2,선형대수학,167,69,98,0.41317365269461076
실버 2,소수 판정,13145,5387,7758,0.4098136173449981
실버 2,라빈–카프,5,2,3,0.4
실버 2,런타임 전의 전처리,269,106,163,0.3940520446096654
실버 2,배낭 문제,875,343,532,0.392
실버 2,최소 공통 조상,154,60,94,0.38961038961038963
실버 2,외판원 순회 문제,132,51,81,0.38636363636363635
실버 2,가장 긴 증가하는 부분 수열: o(n log n),276,106,170,0.38405797101449274
실버 2,정규 표현식,241,92,149,0.3817427385892116
실버 2,에라토스테네스의 체,9823,3743,6080,0.38104448742746616
실버 2,페르마의 소정리,122,46,76,0.3770491803278688
실버 2,삼분 탐색,8,3,5,0.375
실버 2,연결 리스트,1242,460,782,0.37037037037037035
실버 2,비트마스킹,1424,526,898,0.3693820224719101
실버 2,우선순위 큐,3318,1211,2107,0.3649789029535865
실버 2,누적 합,2104,767,1337,0.36454372623574144
실버 2,벨만–포드,217,79,138,0.3640552995391705
실버 2,애드 혹,698,254,444,0.3638968481375358
실버 2,구성적,286,104,182,0.36363636363636365
실버 2,볼록 껍질,33,12,21,0.36363636363636365
실버 2,슬라이딩 윈도우,668,241,427,0.36077844311377244
실버 2,모듈로 곱셈 역원,119,42,77,0.35294117647058826
실버 2,0-1 너비 우선 탐색,204,72,132,0.35294117647058826
실버 2,중국인의 나머지 정리,173,60,113,0.3468208092485549
실버 2,트리에서의 다이나믹 프로그래밍,177,61,116,0.3446327683615819
실버 2,물리학,41,14,27,0.34146341463414637
실버 2,두 포인터,2735,925,1810,0.3382084095063985
실버 2,밀러–라빈 소수 판별법,74,25,49,0.33783783783783783
실버 2,접미사 배열과 lcp 배열,9,3,6,0.3333333333333333
실버 2,이분 탐색,9647,3134,6513,0.3248678345599668
실버 2,폴라드 로,62,20,42,0.3225806451612903
실버 2,비둘기집 원리,62,20,42,0.3225806451612903
실버 2,다익스트라,2260,715,1545,0.3163716814159292
실버 2,매개 변수 탐색,3766,1165,2601,0.30934678704195434
실버 2,분리 집합,989,299,690,0.3023255813953488
실버 2,최대 유량,53,16,37,0.3018867924528302
실버 2,중간에서 만나기,100,30,70,0.3
실버 2,비트필드를 이용한 다이나믹 프로그래밍,203,60,143,0.2955665024630542
실버 2,희소 배열,95,28,67,0.29473684210526313
실버 2,기댓값의 선형성,14,4,10,0.2857142857142857
실버 2,미적분학,35,10,25,0.2857142857142857
실버 2,많은 조건 분기,1166,329,837,0.28216123499142365
실버 2,분할 정복을 이용한 거듭제곱,983,276,707,0.2807731434384537
실버 2,세그먼트 트리,744,206,538,0.2768817204301075
실버 2,수치해석,33,9,24,0.2727272727272727
실버 2,선분 교차 판정,91,24,67,0.26373626373626374
실버 2,강한 연결 요소,19,5,14,0.2631578947368421
실버 2,스위핑,266,69,197,0.2593984962406015
실버 2,3차원 기하학,27,7,20,0.25925925925925924
실버 2,kmp,152,39,113,0.2565789473684211
실버 2,트라이,299,76,223,0.25418060200668896
실버 2,가우스 소거법,4,1,3,0.25
실버 2,느리게 갱신되는 세그먼트 트리,63,14,49,0.2222222222222222
실버 2,포함 배제의 원리,18,4,14,0.2222222222222222
실버 2,다각형의 넓이,86,19,67,0.22093023255813954
실버 2,분할 정복을 사용한 최적화,15,3,12,0.2
실버 2,무작위화,57,10,47,0.17543859649122806
실버 2,제곱근 분할법,6,1,5,0.16666666666666666
실버 2,확장 유클리드 호제법,49,8,41,0.16326530612244897
실버 2,오일러 경로 테크닉,26,4,22,0.15384615384615385
실버 2,뤼카 정리,33,5,28,0.15151515151515152
실버 2,오일러 피 함수,31,4,27,0.12903225806451613
실버 2,아호-코라식,8,1,7,0.125
실버 2,mo's,9,1,8,0.1111111111111111
실버 2,고속 푸리에 변환,28,2,26,0.07142857142857142
실버 2,해싱,129,7,122,0.05426356589147287
실버 2,🧑‍💻,2,0,2,0.0
실버 2,크누스 x,5,0,5,0.0
실버 2,로프,8,0,8,0.0
실버 2,🧵,2,0,2,0.0
실버 2,🏃🤔,2,0,2,0.0
실버 2,회문 트리,6,0,6,0.0
실버 2,매내처,6,0,6,0.0
실버 2,작은 집합에서 큰 집합으로 합치는 테크닉,2,0,2,0.0
실버 2,최대 유량 최소 컷 정리,2,0,2,0.0
실버 2,스플레이 트리,8,0,8,0.0
실버 2,춤추는 링크,5,0,5,0.0
실버 2,2-sat,8,0,8,0.0
실버 2,🌎👨‍💻📄🎱📖🧪,2,0,2,0.0
실버 3,함수 개형을 이용한 최적화,1,1,0,1.0
실버 3,양방향 탐색,1,1,0,1.0
실버 3,오일러 피 함수,1,1,0,1.0
실버 3,휴리스틱,25,25,0,1.0
실버 3,헝가리안,1,1,0,1.0
실버 3,가우스 소거법,1,1,0,1.0
실버 3,반평면 교집합,1,1,0,1.0
실버 3,오일러 지표 (χ=v-e+f),49,42,7,0.8571428571428571
실버 3,순열 사이클 분할,18,14,4,0.7777777777777778
실버 3,사칙연산,43019,29719,13300,0.6908342825263256
실버 3,밀러–라빈 소수 판별법,3,2,1,0.6666666666666666
실버 3,분할 정복을 사용한 최적화,3,2,1,0.6666666666666666
실버 3,구현,87431,57860,29571,0.6617790028708352
실버 3,수학,88140,53308,34832,0.604810528704334
실버 3,기하학,6448,3693,2755,0.5727357320099256
실버 3,문자열,21663,12305,9358,0.5680192032497807
실버 3,큰 수 연산,2731,1495,1236,0.5474185280117173
실버 3,임의 정밀도,2731,1495,1236,0.5474185280117173
실버 3,재귀,3102,1681,1421,0.5419084461637653
실버 3,분할 정복,1447,767,680,0.530062197650311
실버 3,선형대수학,55,29,26,0.5272727272727272
실버 3,피타고라스 정리,1527,801,726,0.5245579567779961
실버 3,유클리드 호제법,1491,776,715,0.5204560697518444
실버 3,큐,2809,1446,1363,0.5147739409042363
실버 3,조합론,1626,837,789,0.514760147601476
실버 3,백트래킹,3578,1832,1746,0.5120178870877585
실버 3,브루트포스 알고리즘,15497,7877,7620,0.5082919274698329
실버 3,게임 이론,181,92,89,0.5082872928176796
실버 3,폴라드 로,2,1,1,0.5
실버 3,삼분 탐색,2,1,1,0.5
실버 3,확률론,32,16,16,0.5
실버 3,단절점과 단절선,2,1,1,0.5
실버 3,오프라인 쿼리,4,2,2,0.5
실버 3,스택,6096,2917,3179,0.47851049868766404
실버 3,시뮬레이션,4059,1927,2132,0.47474747474747475
실버 3,깊이 우선 탐색,5699,2675,3024,0.4693805930865064
실버 3,그리디 알고리즘,10301,4685,5616,0.45481021260071836
실버 3,정렬,19049,8584,10465,0.4506273295186099
실버 3,해시를 사용한 집합과 맵,1477,659,818,0.44617467840216657
실버 3,다이나믹 프로그래밍,12737,5638,7099,0.4426474051974562
실버 3,플로이드–와샬,336,148,188,0.44047619047619047
실버 3,파싱,1378,604,774,0.43831640058055155
실버 3,자료 구조,16026,7013,9013,0.4376013977286909
실버 3,정수론,12158,5285,6873,0.4346932061194275
실버 3,최소 스패닝 트리,231,100,131,0.4329004329004329
실버 3,외판원 순회 문제,51,22,29,0.43137254901960786
실버 3,너비 우선 탐색,10258,4425,5833,0.43137063755117955
실버 3,미적분학,14,6,8,0.42857142857142855
실버 3,배낭 문제,414,176,238,0.4251207729468599
실버 3,연결 리스트,483,204,279,0.422360248447205
실버 3,그래프 탐색,11732,4947,6785,0.4216672349130583
실버 3,소수 판정,9031,3803,5228,0.42110508249363304
실버 3,덱,1230,516,714,0.4195121951219512
실버 3,kmp,86,36,50,0.4186046511627907
실버 3,그래프 이론,13185,5508,7677,0.41774744027303756
실버 3,희소 배열,12,5,7,0.4166666666666667
실버 3,트리,981,408,573,0.41590214067278286
실버 3,위상 정렬,157,65,92,0.4140127388535032
실버 3,뤼카 정리,5,2,3,0.4
실버 3,트리를 사용한 집합과 맵,380,149,231,0.39210526315789473
실버 3,에라토스테네스의 체,6717,2620,4097,0.3900550841149323
실버 3,최소 공통 조상,59,23,36,0.3898305084745763
실버 3,비트마스킹,732,279,453,0.38114754098360654
실버 3,구성적,141,53,88,0.375886524822695
실버 3,가장 긴 증가하는 부분 수열: o(n log n),173,65,108,0.37572254335260113
실버 3,정규 표현식,128,48,80,0.375
실버 3,좌표 압축,404,150,254,0.3712871287128713
실버 3,값,404,150,254,0.3712871287128713
실버 3,런타임 전의 전처리,169,61,108,0.3609467455621302
실버 3,두 포인터,1644,577,1067,0.35097323600973235
실버 3,우선순위 큐,1820,627,1193,0.3445054945054945
실버 3,다익스트라,1049,359,690,0.342230695900858
실버 3,애드 혹,459,157,302,0.3420479302832244
실버 3,비둘기집 원리,39,13,26,0.3333333333333333
실버 3,볼록 껍질,49,16,33,0.32653061224489793
실버 3,비트필드를 이용한 다이나믹 프로그래밍,50,16,34,0.32
실버 3,많은 조건 분기,625,197,428,0.3152
실버 3,세그먼트 트리,321,99,222,0.308411214953271
실버 3,트라이,78,24,54,0.3076923076923077
실버 3,느리게 갱신되는 세그먼트 트리,13,4,9,0.3076923076923077
실버 3,중간에서 만나기,43,13,30,0.3023255813953488
실버 3,기댓값의 선형성,10,3,7,0.3
실버 3,다각형의 넓이,50,15,35,0.3
실버 3,이분 탐색,5433,1591,3842,0.2928400515369041
실버 3,0-1 너비 우선 탐색,93,27,66,0.2903225806451613
실버 3,누적 합,1194,342,852,0.2864321608040201
실버 3,트리에서의 다이나믹 프로그래밍,74,21,53,0.28378378378378377
실버 3,중국인의 나머지 정리,67,19,48,0.2835820895522388
실버 3,분리 집합,462,129,333,0.2792207792207792
실버 3,매개 변수 탐색,2088,568,1520,0.2720306513409962
실버 3,최대 유량,15,4,11,0.26666666666666666
실버 3,벨만–포드,83,22,61,0.26506024096385544
실버 3,모듈로 곱셈 역원,61,16,45,0.26229508196721313
실버 3,페르마의 소정리,54,14,40,0.25925925925925924
실버 3,다차원 세그먼트 트리,4,1,3,0.25
실버 3,스위핑,164,41,123,0.25
실버 3,분할 정복을 이용한 거듭제곱,379,93,286,0.24538258575197888
실버 3,슬라이딩 윈도우,364,81,283,0.22252747252747251
실버 3,강한 연결 요소,19,4,15,0.21052631578947367
실버 3,물리학,10,2,8,0.2
실버 3,수치해석,106,20,86,0.18867924528301888
실버 3,회전하는 캘리퍼스,27,5,22,0.18518518518518517
실버 3,매내처,11,2,9,0.18181818181818182
실버 3,선분 교차 판정,14,2,12,0.14285714285714285
실버 3,오목 다각형 내부의 점 판정,7,1,6,0.14285714285714285
실버 3,3차원 기하학,36,5,31,0.1388888888888889
실버 3,머지 소트 트리,22,3,19,0.13636363636363635
실버 3,비트 집합,8,1,7,0.125
실버 3,확장 유클리드 호제법,33,4,29,0.12121212121212122
실버 3,이분 매칭,76,5,71,0.06578947368421052
실버 3,포함 배제의 원리,17,1,16,0.058823529411764705
실버 3,볼록 껍질을 이용한 최적화,1,0,1,0.0
실버 3,퍼시스턴트 세그먼트 트리,1,0,1,0.0
실버 3,무작위화,7,0,7,0.0
실버 3,고속 푸리에 변환,5,0,5,0.0
실버 3,접미사 배열과 lcp 배열,6,0,6,0.0
실버 3,제곱근 분할법,3,0,3,0.0
실버 3,최소 비용 최대 유량,1,0,1,0.0
실버 3,오일러 경로,2,0,2,0.0
실버 3,라빈–카프,6,0,6,0.0
실버 3,뫼비우스 반전 공식,3,0,3,0.0
실버 3,해싱,35,0,35,0.0
실버 4,오일러 피 함수,1,1,0,1.0
실버 4,병렬 이분 탐색,1,1,0,1.0
실버 4,커넥션 프로파일을 이용한 다이나믹 프로그래밍,1,1,0,1.0
실버 4,볼록 껍질을 이용한 최적화,4,4,0,1.0
실버 4,평면 그래프,1,1,0,1.0
실버 4,mo's,1,1,0,1.0
실버 4,센트로이드 분할,5,5,0,1.0
실버 4,센트로이드,5,5,0,1.0
실버 4,함수 개형을 이용한 최적화,1,1,0,1.0
실버 4,2-sat,1,1,0,1.0
실버 4,히르쉬버그,1,1,0,1.0
실버 4,쌍대 그래프,1,1,0,1.0
실버 4,오일러 지표 (χ=v-e+f),31,26,5,0.8387096774193549
실버 4,최대 유량 최소 컷 정리,6,4,2,0.6666666666666666
실버 4,볼록 껍질,6,4,2,0.6666666666666666
실버 4,볼록 다각형 내부의 점 판정,3,2,1,0.6666666666666666
실버 4,사칙연산,55076,35789,19287,0.6498111700196093
실버 4,구현,107392,69075,38317,0.6432043355184743
실버 4,게임 이론,213,131,82,0.6150234741784038
실버 4,최소 공통 조상,59,36,23,0.6101694915254238
실버 4,기댓값의 선형성,5,3,2,0.6
실버 4,최대 유량,29,17,12,0.5862068965517241
실버 4,기하학,7129,4172,2957,0.5852153177163698
실버 4,수학,110021,64053,45968,0.5821888548549823
실버 4,미적분학,7,4,3,0.5714285714285714
실버 4,피타고라스 정리,1438,806,632,0.5605006954102921
실버 4,조합론,1280,707,573,0.55234375
실버 4,분할 정복,1293,702,591,0.54292343387471
실버 4,백트래킹,3066,1655,1411,0.5397912589693412
실버 4,문자열,25973,14018,11955,0.5397143187155893
실버 4,재귀,2854,1501,1353,0.5259285213735109
실버 4,플로이드–와샬,247,127,120,0.5141700404858299
실버 4,브루트포스 알고리즘,14458,7387,7071,0.5109282058375986
실버 4,비트 집합,2,1,1,0.5
실버 4,최소 비용 최대 유량,2,1,1,0.5
실버 4,이분 그래프,2,1,1,0.5
실버 4,번사이드 보조정리,2,1,1,0.5
실버 4,단절점과 단절선,4,2,2,0.5
실버 4,임의 정밀도,3291,1640,1651,0.49832877544819204
실버 4,큰 수 연산,3291,1640,1651,0.49832877544819204
실버 4,유클리드 호제법,1281,638,643,0.49804839968774395
실버 4,큐,2667,1323,1344,0.49606299212598426
실버 4,순열 사이클 분할,21,10,11,0.47619047619047616
실버 4,파싱,1113,509,604,0.4573225516621743
실버 4,스택,6325,2879,3446,0.4551778656126482
실버 4,선형대수학,84,38,46,0.4523809523809524
실버 4,런타임 전의 전처리,100,45,55,0.45
실버 4,정규 표현식,121,54,67,0.4462809917355372
실버 4,그리디 알고리즘,10734,4770,5964,0.44438233650083847
실버 4,깊이 우선 탐색,4970,2194,2776,0.4414486921529175
실버 4,다이나믹 프로그래밍,11726,5121,6605,0.43672181477059524
실버 4,위상 정렬,188,82,106,0.43617021276595747
실버 4,시뮬레이션,3901,1683,2218,0.431427839015637
실버 4,너비 우선 탐색,8170,3515,4655,0.43023255813953487
실버 4,정렬,16303,6971,9332,0.4275900141078329
실버 4,트리,892,378,514,0.42376681614349776
실버 4,그래프 탐색,9457,3950,5507,0.41768002537802684
실버 4,정수론,14746,6123,8623,0.41523124915231246
실버 4,트리에서의 다이나믹 프로그래밍,73,30,43,0.410958904109589
실버 4,자료 구조,16079,6595,9484,0.4101623235275826
실버 4,그래프 이론,11054,4533,6521,0.410077799891442
실버 4,연결 리스트,549,225,324,0.4098360655737705
실버 4,최소 스패닝 트리,242,99,143,0.4090909090909091
실버 4,외판원 순회 문제,44,18,26,0.4090909090909091
실버 4,소수 판정,12048,4854,7194,0.4028884462151394
실버 4,작은 집합에서 큰 집합으로 합치는 테크닉,5,2,3,0.4
실버 4,덱,1069,426,643,0.3985032740879326
실버 4,해시를 사용한 집합과 맵,1638,642,996,0.39194139194139194
실버 4,다각형의 넓이,24,9,15,0.375
실버 4,비트마스킹,646,242,404,0.3746130030959752
실버 4,에라토스테네스의 체,8657,3196,5461,0.36918100958761696
실버 4,비트필드를 이용한 다이나믹 프로그래밍,53,19,34,0.3584905660377358
실버 4,값,261,92,169,0.3524904214559387
실버 4,좌표 압축,261,92,169,0.3524904214559387
실버 4,느리게 갱신되는 세그먼트 트리,23,8,15,0.34782608695652173
실버 4,슬라이딩 윈도우,406,137,269,0.3374384236453202
실버 4,가장 긴 증가하는 부분 수열: o(n log n),152,51,101,0.3355263157894737
실버 4,무작위화,3,1,2,0.3333333333333333
실버 4,제곱근 분할법,3,1,2,0.3333333333333333
실버 4,선인장,3,1,2,0.3333333333333333
실버 4,이중 연결 요소,3,1,2,0.3333333333333333
실버 4,확률론,49,16,33,0.32653061224489793
실버 4,두 포인터,1535,489,1046,0.31856677524429966
실버 4,배낭 문제,449,141,308,0.31403118040089084
실버 4,선분 교차 판정,51,16,35,0.3137254901960784
실버 4,벨만–포드,118,37,81,0.3135593220338983
실버 4,트리를 사용한 집합과 맵,396,124,272,0.31313131313131315
실버 4,우선순위 큐,1689,528,1161,0.31261101243339257
실버 4,다익스트라,1048,327,721,0.31202290076335876
실버 4,누적 합,1167,351,816,0.30077120822622105
실버 4,트라이,160,48,112,0.3
실버 4,스위핑,171,49,122,0.28654970760233917
실버 4,분리 집합,514,147,367,0.28599221789883267
실버 4,애드 혹,323,92,231,0.2848297213622291
실버 4,많은 조건 분기,573,163,410,0.2844677137870855
실버 4,0-1 너비 우선 탐색,112,31,81,0.2767857142857143
실버 4,분할 정복을 이용한 거듭제곱,418,115,303,0.2751196172248804
실버 4,이분 탐색,5021,1379,3642,0.2746464847639912
실버 4,세그먼트 트리,310,85,225,0.27419354838709675
실버 4,중간에서 만나기,49,13,36,0.2653061224489796
실버 4,희소 배열,42,11,31,0.2619047619047619
실버 4,매개 변수 탐색,1898,486,1412,0.256059009483667
실버 4,라빈–카프,8,2,6,0.25
실버 4,포함 배제의 원리,4,1,3,0.25
실버 4,양방향 탐색,4,1,3,0.25
실버 4,중국인의 나머지 정리,58,14,44,0.2413793103448276
실버 4,확장 유클리드 호제법,25,6,19,0.24
실버 4,접미사 배열과 lcp 배열,13,3,10,0.23076923076923078
실버 4,3차원 기하학,9,2,7,0.2222222222222222
실버 4,구성적,154,34,120,0.22077922077922077
실버 4,이분 매칭,32,7,25,0.21875
실버 4,비둘기집 원리,29,6,23,0.20689655172413793
실버 4,삼분 탐색,5,1,4,0.2
실버 4,가우스 소거법,5,1,4,0.2
실버 4,kmp,101,20,81,0.19801980198019803
실버 4,모듈로 곱셈 역원,51,10,41,0.19607843137254902
실버 4,매내처,31,6,25,0.1935483870967742
실버 4,페르마의 소정리,42,8,34,0.19047619047619047
실버 4,밀러–라빈 소수 판별법,22,4,18,0.18181818181818182
실버 4,오프라인 쿼리,25,4,21,0.16
실버 4,폴라드 로,21,3,18,0.14285714285714285
실버 4,고속 푸리에 변환,22,3,19,0.13636363636363635
실버 4,강한 연결 요소,36,4,32,0.1111111111111111
실버 4,해싱,32,3,29,0.09375
실버 4,안정 결혼 문제,15,1,14,0.06666666666666667
실버 4,뤼카 정리,17,1,16,0.058823529411764705
실버 4,스플레이 트리,4,0,4,0.0
실버 4,heavy-light 분할,2,0,2,0.0
실버 4,상수 최적화,4,0,4,0.0
실버 4,크누스 최적화,1,0,1,0.0
실버 4,접미사 트리,4,0,4,0.0
실버 4,수치해석,25,0,25,0.0
실버 4,크누스 x,6,0,6,0.0
실버 4,아호-코라식,2,0,2,0.0
실버 4,z,2,0,2,0.0
실버 4,춤추는 링크,6,0,6,0.0
실버 4,오일러 경로 테크닉,4,0,4,0.0
실버 4,머지 소트 트리,7,0,7,0.0
실버 5,a*,1,1,0,1.0
실버 5,오일러 경로 테크닉,1,1,0,1.0
실버 5,스플레이 트리,4,4,0,1.0
실버 5,작은 집합에서 큰 집합으로 합치는 테크닉,1,1,0,1.0
실버 5,일반적인 매칭,1,1,0,1.0
실버 5,매트로이드,1,1,0,1.0
실버 5,서큘레이션,1,1,0,1.0
실버 5,함수 개형을 이용한 최적화,6,6,0,1.0
실버 5,강한 연결 요소,2,2,0,1.0
실버 5,컷 트리,1,1,0,1.0
실버 5,삼분 탐색,1,1,0,1.0
실버 5,2-sat,1,1,0,1.0
실버 5,최소 비용 최대 유량,2,2,0,1.0
실버 5,기댓값의 선형성,1,1,0,1.0
실버 5,회전하는 캘리퍼스,1,1,0,1.0
실버 5,링크,1,1,0,1.0
실버 5,담금질 기법,1,1,0,1.0
실버 5,포함 배제의 원리,5,4,1,0.8
실버 5,오일러 지표 (χ=v-e+f),29,22,7,0.7586206896551724
실버 5,게임 이론,103,69,34,0.6699029126213593
실버 5,최대 유량,15,10,5,0.6666666666666666
실버 5,구현,144022,92459,51563,0.6419783088694783
실버 5,사칙연산,79854,50909,28945,0.6375259849224836
실버 5,트리에서의 다이나믹 프로그래밍,20,12,8,0.6
실버 5,수학,129971,77613,52358,0.5971562887105585
실버 5,기하학,5164,3026,2138,0.5859798605731991
실버 5,최소 공통 조상,31,17,14,0.5483870967741935
실버 5,문자열,31427,16932,14495,0.5387723931651128
실버 5,임의 정밀도,2658,1379,1279,0.5188111361926261
실버 5,큰 수 연산,2658,1379,1279,0.5188111361926261
실버 5,이산 로그,2,1,1,0.5
실버 5,센트로이드 분할,2,1,1,0.5
실버 5,센트로이드,2,1,1,0.5
실버 5,브루트포스 알고리즘,13917,6926,6991,0.497664726593375
실버 5,파싱,789,390,399,0.49429657794676807
실버 5,큐,2033,1002,1031,0.4928676832267585
실버 5,재귀,1750,855,895,0.48857142857142855
실버 5,조합론,1224,595,629,0.4861111111111111
실버 5,피타고라스 정리,1002,477,525,0.47604790419161674
실버 5,백트래킹,2624,1248,1376,0.47560975609756095
실버 5,분할 정복,767,360,407,0.46936114732724904
실버 5,유클리드 호제법,1139,521,618,0.45741878841088673
실버 5,깊이 우선 탐색,4131,1873,2258,0.4534011135318325
실버 5,최소 스패닝 트리,144,63,81,0.4375
실버 5,스택,4982,2137,2845,0.4289441991168206
실버 5,런타임 전의 전처리,84,36,48,0.42857142857142855
실버 5,그리디 알고리즘,9947,4238,5709,0.42605810797225296
실버 5,너비 우선 탐색,7030,2975,4055,0.42318634423897583
실버 5,시뮬레이션,3246,1373,1873,0.42298213185459027
실버 5,정렬,13237,5588,7649,0.42215003399561835
실버 5,덱,719,301,418,0.41863699582753827
실버 5,다이나믹 프로그래밍,9547,3943,5604,0.413009322300199
실버 5,이분 매칭,17,7,10,0.4117647058823529
실버 5,그래프 탐색,7918,3248,4670,0.41020459712048496
실버 5,정수론,7458,3027,4431,0.40587288817377315
실버 5,그래프 이론,8976,3595,5381,0.40051247771836007
실버 5,순열 사이클 분할,15,6,9,0.4
실버 5,트리,583,233,350,0.3996569468267582
실버 5,자료 구조,12427,4931,7496,0.3967972962098656
실버 5,느리게 갱신되는 세그먼트 트리,44,17,27,0.38636363636363635
실버 5,해시를 사용한 집합과 맵,1115,428,687,0.38385650224215245
실버 5,배낭 문제,304,116,188,0.3815789473684211
실버 5,소수 판정,5015,1913,3102,0.3814556331006979
실버 5,정규 표현식,119,45,74,0.37815126050420167
실버 5,0-1 너비 우선 탐색,45,17,28,0.37777777777777777
실버 5,3차원 기하학,8,3,5,0.375
실버 5,플로이드–와샬,219,82,137,0.3744292237442922
실버 5,가장 긴 증가하는 부분 수열: o(n log n),113,42,71,0.37168141592920356
실버 5,모듈로 곱셈 역원,35,13,22,0.37142857142857144
실버 5,확률론,19,7,12,0.3684210526315789
실버 5,희소 배열,14,5,9,0.35714285714285715
실버 5,비트마스킹,541,193,348,0.3567467652495379
실버 5,에라토스테네스의 체,3626,1228,2398,0.33866519580805293
실버 5,연결 리스트,442,148,294,0.334841628959276
실버 5,제곱근 분할법,6,2,4,0.3333333333333333
실버 5,휴리스틱,3,1,2,0.3333333333333333
실버 5,누적 합,987,326,661,0.3302938196555218
실버 5,애드 혹,334,109,225,0.3263473053892216
실버 5,좌표 압축,178,58,120,0.3258426966292135
실버 5,값,178,58,120,0.3258426966292135
실버 5,구성적,159,51,108,0.32075471698113206
실버 5,분할 정복을 이용한 거듭제곱,322,103,219,0.3198757763975155
실버 5,외판원 순회 문제,44,14,30,0.3181818181818182
실버 5,트리를 사용한 집합과 맵,238,74,164,0.31092436974789917
실버 5,두 포인터,1075,332,743,0.30883720930232555
실버 5,페르마의 소정리,26,8,18,0.3076923076923077
실버 5,슬라이딩 윈도우,275,84,191,0.3054545454545455
실버 5,선형대수학,95,29,66,0.30526315789473685
실버 5,우선순위 큐,1496,456,1040,0.3048128342245989
실버 5,다익스트라,795,239,556,0.30062893081761005
실버 5,세그먼트 트리,304,87,217,0.28618421052631576
실버 5,위상 정렬,162,46,116,0.2839506172839506
실버 5,kmp,46,13,33,0.2826086956521739
실버 5,이분 탐색,3883,1078,2805,0.2776203966005666
실버 5,비트필드를 이용한 다이나믹 프로그래밍,47,13,34,0.2765957446808511
실버 5,매개 변수 탐색,1392,381,1011,0.27370689655172414
실버 5,밀러–라빈 소수 판별법,11,3,8,0.2727272727272727
실버 5,고속 푸리에 변환,11,3,8,0.2727272727272727
실버 5,오프라인 동적 연결성 판정,11,3,8,0.2727272727272727
실버 5,오일러 경로,23,6,17,0.2608695652173913
실버 5,히르쉬버그,4,1,3,0.25
실버 5,미적분학,25,6,19,0.24
실버 5,분리 집합,275,66,209,0.24
실버 5,많은 조건 분기,508,121,387,0.23818897637795275
실버 5,heavy-light 분할,9,2,7,0.2222222222222222
실버 5,뤼카 정리,28,6,22,0.21428571428571427
실버 5,트라이,115,23,92,0.2
실버 5,볼록 껍질을 이용한 최적화,5,1,4,0.2
실버 5,다각형의 넓이,21,4,17,0.19047619047619047
실버 5,중국인의 나머지 정리,59,11,48,0.1864406779661017
실버 5,중간에서 만나기,22,4,18,0.18181818181818182
실버 5,오프라인 쿼리,22,4,18,0.18181818181818182
실버 5,수치해석,53,9,44,0.16981132075471697
실버 5,오일러 피 함수,6,1,5,0.16666666666666666
실버 5,벨만–포드,68,11,57,0.16176470588235295
실버 5,스위핑,192,31,161,0.16145833333333334
실버 5,선분 교차 판정,75,11,64,0.14666666666666667
실버 5,폴라드 로,7,1,6,0.14285714285714285
실버 5,비둘기집 원리,28,4,24,0.14285714285714285
실버 5,mo's,7,1,6,0.14285714285714285
실버 5,확장 유클리드 호제법,37,5,32,0.13513513513513514
실버 5,라빈–카프,11,1,10,0.09090909090909091
실버 5,접미사 배열과 lcp 배열,13,1,12,0.07692307692307693
실버 5,볼록 껍질,42,3,39,0.07142857142857142
실버 5,무작위화,45,2,43,0.044444444444444446
실버 5,해싱,46,1,45,0.021739130434782608
실버 5,🧵,6,0,6,0.0
실버 5,다차원 세그먼트 트리,1,0,1,0.0
실버 5,매내처,2,0,2,0.0
실버 5,🧑‍💻,6,0,6,0.0
실버 5,aliens 트릭,1,0,1,0.0
실버 5,🏃🤔,6,0,6,0.0
실버 5,비트 집합,8,0,8,0.0
실버 5,🌎👨‍💻📄🎱📖🧪,6,0,6,0.0
실버 5,물리학,2,0,2,0.0
실버 5,머지 소트 트리,8,0,8,0.0
플래티넘 1,이산 로그,3,3,0,1.0
플래티넘 1,히르쉬버그,1,1,0,1.0
플래티넘 1,이분 그래프,1,1,0,1.0
플래티넘 1,아호-코라식,4,4,0,1.0
플래티넘 1,오프라인 동적 연결성 판정,6,6,0,1.0
플래티넘 1,분할 정복을 사용한 최적화,8,8,0,1.0
플래티넘 1,비트 집합,10,9,1,0.9
플래티넘 1,오일러 지표 (χ=v-e+f),21,17,4,0.8095238095238095
플래티넘 1,스플레이 트리,10,8,2,0.8
플래티넘 1,사칙연산,2545,1960,585,0.7701375245579568
플래티넘 1,모듈로 곱셈 역원,117,87,30,0.7435897435897436
플래티넘 1,휴리스틱,129,95,34,0.7364341085271318
플래티넘 1,정규 표현식,44,32,12,0.7272727272727273
플래티넘 1,담금질 기법,119,86,33,0.7226890756302521
플래티넘 1,구현,5573,3938,1635,0.7066212094024762
플래티넘 1,페르마의 소정리,88,62,26,0.7045454545454546
플래티넘 1,확률론,98,69,29,0.7040816326530612
플래티넘 1,플로이드–와샬,254,174,80,0.6850393700787402
플래티넘 1,통계학,19,13,6,0.6842105263157895
플래티넘 1,시뮬레이션,707,478,229,0.6760961810466761
플래티넘 1,베이즈 정리,18,12,6,0.6666666666666666
플래티넘 1,가장 긴 증가하는 부분 수열: o(n log n),243,159,84,0.654320987654321
플래티넘 1,스택,565,367,198,0.6495575221238938
플래티넘 1,문자열,2465,1588,877,0.6442190669371197
플래티넘 1,조합론,759,481,278,0.6337285902503293
플래티넘 1,최소 비용 최대 유량,130,82,48,0.6307692307692307
플래티넘 1,수학,8169,5145,3024,0.6298200514138818
플래티넘 1,슬라이딩 윈도우,176,110,66,0.625
플래티넘 1,브루트포스 알고리즘,2012,1257,755,0.6247514910536779
플래티넘 1,피타고라스 정리,134,83,51,0.6194029850746269
플래티넘 1,백트래킹,640,395,245,0.6171875
플래티넘 1,라빈–카프,91,56,35,0.6153846153846154
플래티넘 1,재귀,322,197,125,0.6118012422360248
플래티넘 1,로프,18,11,7,0.6111111111111112
플래티넘 1,트리를 사용한 집합과 맵,251,153,98,0.6095617529880478
플래티넘 1,덱,197,120,77,0.6091370558375635
플래티넘 1,미적분학,56,34,22,0.6071428571428571
플래티넘 1,해시를 사용한 집합과 맵,454,275,179,0.6057268722466961
플래티넘 1,함수 개형을 이용한 최적화,10,6,4,0.6
플래티넘 1,큐,114,68,46,0.5964912280701754
플래티넘 1,확장 유클리드 호제법,52,31,21,0.5961538461538461
플래티넘 1,유클리드 호제법,202,120,82,0.594059405940594
플래티넘 1,비둘기집 원리,22,13,9,0.5909090909090909
플래티넘 1,누적 합,728,428,300,0.5879120879120879
플래티넘 1,머지 소트 트리,84,49,35,0.5833333333333334
플래티넘 1,스프라그–그런디 정리,85,49,36,0.5764705882352941
플래티넘 1,깊이 우선 탐색,1069,615,454,0.5753040224508886
플래티넘 1,정렬,2192,1253,939,0.5716240875912408
플래티넘 1,매내처,35,20,15,0.5714285714285714
플래티넘 1,3차원 기하학,46,26,20,0.5652173913043478
플래티넘 1,에라토스테네스의 체,425,240,185,0.5647058823529412
플래티넘 1,선형대수학,78,44,34,0.5641025641025641
플래티넘 1,무작위화,94,53,41,0.5638297872340425
플래티넘 1,희소 배열,175,98,77,0.56
플래티넘 1,우선순위 큐,704,394,310,0.5596590909090909
플래티넘 1,2-sat,151,84,67,0.5562913907284768
플래티넘 1,강한 연결 요소,349,194,155,0.5558739255014327
플래티넘 1,분할 정복을 이용한 거듭제곱,414,230,184,0.5555555555555556
플래티넘 1,다이나믹 프로그래밍,4472,2476,1996,0.5536672629695886
플래티넘 1,자료 구조,4776,2639,2137,0.5525544388609716
플래티넘 1,게임 이론,317,174,143,0.5488958990536278
플래티넘 1,소수 판정,719,393,326,0.5465924895688457
플래티넘 1,밀러–라빈 소수 판별법,167,91,76,0.5449101796407185
플래티넘 1,배낭 문제,281,153,128,0.5444839857651246
플래티넘 1,정수론,1816,988,828,0.5440528634361234
플래티넘 1,좌표 압축,137,74,63,0.5401459854014599
플래티넘 1,위상 정렬,274,148,126,0.5401459854014599
플래티넘 1,값,137,74,63,0.5401459854014599
플래티넘 1,너비 우선 탐색,1661,897,764,0.5400361228175797
플래티넘 1,그리디 알고리즘,2189,1175,1014,0.5367747830059388
플래티넘 1,그래프 탐색,2725,1455,1270,0.5339449541284403
플래티넘 1,트리에서의 다이나믹 프로그래밍,231,123,108,0.5324675324675324
플래티넘 1,세그먼트 트리,1821,968,853,0.5315760571114773
플래티넘 1,덱을 이용한 다이나믹 프로그래밍,17,9,8,0.5294117647058824
플래티넘 1,그래프 이론,4780,2525,2255,0.5282426778242678
플래티넘 1,최소 스패닝 트리,339,179,160,0.528023598820059
플래티넘 1,폴라드 로,114,60,54,0.5263157894736842
플래티넘 1,분할 정복,387,203,184,0.524547803617571
플래티넘 1,이분 매칭,521,273,248,0.5239923224568138
플래티넘 1,파싱,257,133,124,0.5175097276264592
플래티넘 1,kmp,310,160,150,0.5161290322580645
플래티넘 1,두 포인터,669,345,324,0.515695067264574
플래티넘 1,뤼카 정리,39,20,19,0.5128205128205128
플래티넘 1,연결 리스트,77,39,38,0.5064935064935064
플래티넘 1,매개 변수 탐색,293,148,145,0.5051194539249146
플래티넘 1,비트마스킹,710,358,352,0.504225352112676
플래티넘 1,분리 집합,481,242,239,0.5031185031185031
플래티넘 1,애드 혹,575,289,286,0.5026086956521739
플래티넘 1,가우스 소거법,20,10,10,0.5
플래티넘 1,런타임 전의 전처리,90,45,45,0.5
플래티넘 1,크누스 x,4,2,2,0.5
플래티넘 1,단절점과 단절선,64,32,32,0.5
플래티넘 1,인터프리터,2,1,1,0.5
플래티넘 1,이산 제곱근,2,1,1,0.5
플래티넘 1,춤추는 링크,4,2,2,0.5
플래티넘 1,비트필드를 이용한 다이나믹 프로그래밍,362,180,182,0.4972375690607735
플래티넘 1,트리,1211,601,610,0.4962840627580512
플래티넘 1,포함 배제의 원리,142,70,72,0.49295774647887325
플래티넘 1,느리게 갱신되는 세그먼트 트리,356,175,181,0.49157303370786515
플래티넘 1,최소 공통 조상,295,144,151,0.488135593220339
플래티넘 1,큰 수 연산,485,236,249,0.4865979381443299
플래티넘 1,임의 정밀도,485,236,249,0.4865979381443299
플래티넘 1,물리학,35,17,18,0.4857142857142857
플래티넘 1,다익스트라,786,380,406,0.48346055979643765
플래티넘 1,최대 유량,534,258,276,0.48314606741573035
플래티넘 1,트라이,243,117,126,0.48148148148148145
플래티넘 1,z,42,20,22,0.47619047619047616
플래티넘 1,오프라인 쿼리,313,148,165,0.4728434504792332
플래티넘 1,스위핑,349,164,185,0.4699140401146132
플래티넘 1,다각형의 넓이,45,21,24,0.4666666666666667
플래티넘 1,이분 탐색,1772,815,957,0.45993227990970653
플래티넘 1,많은 조건 분기,368,169,199,0.4592391304347826
플래티넘 1,오일러 경로 테크닉,83,38,45,0.4578313253012048
플래티넘 1,뫼비우스 반전 공식,33,15,18,0.45454545454545453
플래티넘 1,구성적,353,159,194,0.45042492917847027
플래티넘 1,기하학,1260,566,694,0.4492063492063492
플래티넘 1,외판원 순회 문제,59,26,33,0.4406779661016949
플래티넘 1,오일러 피 함수,92,40,52,0.43478260869565216
플래티넘 1,기댓값의 선형성,7,3,4,0.42857142857142855
플래티넘 1,중국인의 나머지 정리,26,11,15,0.4230769230769231
플래티넘 1,작은 집합에서 큰 집합으로 합치는 테크닉,31,13,18,0.41935483870967744
플래티넘 1,해싱,175,71,104,0.4057142857142857
플래티넘 1,순열 사이클 분할,55,22,33,0.4
플래티넘 1,mo's,191,73,118,0.38219895287958117
플래티넘 1,회전하는 캘리퍼스,89,34,55,0.38202247191011235
플래티넘 1,접미사 배열과 lcp 배열,126,48,78,0.38095238095238093
플래티넘 1,선인장,21,8,13,0.38095238095238093
플래티넘 1,중간에서 만나기,185,70,115,0.3783783783783784
플래티넘 1,오일러 경로,59,22,37,0.3728813559322034
플래티넘 1,0-1 너비 우선 탐색,54,20,34,0.37037037037037035
플래티넘 1,퍼시스턴트 세그먼트 트리,22,8,14,0.36363636363636365
플래티넘 1,a*,11,4,7,0.36363636363636365
플래티넘 1,제곱근 분할법,86,31,55,0.36046511627906974
플래티넘 1,다차원 세그먼트 트리,29,10,19,0.3448275862068966
플래티넘 1,고속 푸리에 변환,203,69,134,0.3399014778325123
플래티넘 1,벨만–포드,130,44,86,0.3384615384615385
플래티넘 1,양방향 탐색,3,1,2,0.3333333333333333
플래티넘 1,4차원 이상의 기하학,3,1,2,0.3333333333333333
플래티넘 1,이중 연결 요소,19,6,13,0.3157894736842105
플래티넘 1,볼록 껍질,378,119,259,0.3148148148148148
플래티넘 1,선분 교차 판정,202,63,139,0.3118811881188119
플래티넘 1,볼록 껍질을 이용한 최적화,40,12,28,0.3
플래티넘 1,병렬 이분 탐색,10,3,7,0.3
플래티넘 1,최대 유량 최소 컷 정리,85,25,60,0.29411764705882354
플래티넘 1,수치해석,130,36,94,0.27692307692307694
플래티넘 1,볼록 다각형 내부의 점 판정,55,14,41,0.2545454545454545
플래티넘 1,센트로이드,21,5,16,0.23809523809523808
플래티넘 1,센트로이드 분할,18,4,14,0.2222222222222222
플래티넘 1,삼분 탐색,71,15,56,0.2112676056338028
플래티넘 1,평면 그래프,6,1,5,0.16666666666666666
플래티넘 1,생성 함수,6,1,5,0.16666666666666666
플래티넘 1,heavy-light 분할,63,9,54,0.14285714285714285
플래티넘 1,벌래캠프–매시,7,1,6,0.14285714285714285
플래티넘 1,반평면 교집합,31,2,29,0.06451612903225806
플래티넘 1,헝가리안,1,0,1,0.0
플래티넘 2,히르쉬버그,2,2,0,1.0
플래티넘 2,담금질 기법,81,71,10,0.8765432098765432
플래티넘 2,기댓값의 선형성,8,7,1,0.875
플래티넘 2,휴리스틱,93,80,13,0.8602150537634409
플래티넘 2,안정 결혼 문제,26,21,5,0.8076923076923077
플래티넘 2,오일러 지표 (χ=v-e+f),10,8,2,0.8
플래티넘 2,사칙연산,2705,2002,703,0.7401109057301294
플래티넘 2,피타고라스 정리,124,87,37,0.7016129032258065
플래티넘 2,물리학,13,9,4,0.6923076923076923
플래티넘 2,함수 개형을 이용한 최적화,3,2,1,0.6666666666666666
플래티넘 2,재귀,404,268,136,0.6633663366336634
플래티넘 2,가장 긴 증가하는 부분 수열: o(n log n),231,152,79,0.658008658008658
플래티넘 2,슬라이딩 윈도우,212,138,74,0.6509433962264151
플래티넘 2,순열 사이클 분할,34,22,12,0.6470588235294118
플래티넘 2,분할 정복을 사용한 최적화,14,9,5,0.6428571428571429
플래티넘 2,큐,219,139,80,0.634703196347032
플래티넘 2,구현,8521,5368,3153,0.6299730078629269
플래티넘 2,모듈로 곱셈 역원,205,129,76,0.6292682926829268
플래티넘 2,머지 소트 트리,100,60,40,0.6
플래티넘 2,해시를 사용한 집합과 맵,527,313,214,0.5939278937381404
플래티넘 2,비트 집합,27,16,11,0.5925925925925926
플래티넘 2,확률론,118,69,49,0.5847457627118644
플래티넘 2,선형대수학,47,27,20,0.574468085106383
플래티넘 2,유클리드 호제법,299,171,128,0.5719063545150501
플래티넘 2,작은 집합에서 큰 집합으로 합치는 테크닉,7,4,3,0.5714285714285714
플래티넘 2,스택,851,483,368,0.5675675675675675
플래티넘 2,분할 정복을 이용한 거듭제곱,477,269,208,0.5639412997903563
플래티넘 2,수학,10293,5795,4498,0.5630039832896143
플래티넘 2,정규 표현식,52,29,23,0.5576923076923077
플래티넘 2,브루트포스 알고리즘,3188,1773,1415,0.5561480552070264
플래티넘 2,에라토스테네스의 체,649,358,291,0.551617873651772
플래티넘 2,문자열,3443,1896,1547,0.550682544292768
플래티넘 2,페르마의 소정리,187,102,85,0.5454545454545454
플래티넘 2,희소 배열,391,213,178,0.5447570332480819
플래티넘 2,최소 스패닝 트리,583,317,266,0.5437392795883362
플래티넘 2,시뮬레이션,1827,992,835,0.5429666119321291
플래티넘 2,최소 공통 조상,473,254,219,0.5369978858350951
플래티넘 2,스프라그–그런디 정리,38,20,18,0.5263157894736842
플래티넘 2,정렬,3173,1666,1507,0.5250551528521904
플래티넘 2,조합론,860,451,409,0.5244186046511627
플래티넘 2,백트래킹,1290,673,617,0.5217054263565891
플래티넘 2,게임 이론,305,158,147,0.5180327868852459
플래티넘 2,비트마스킹,978,503,475,0.5143149284253579
플래티넘 2,플로이드–와샬,409,207,202,0.5061124694376528
플래티넘 2,깊이 우선 탐색,1900,960,940,0.5052631578947369
플래티넘 2,분할 정복,704,353,351,0.5014204545454546
플래티넘 2,위상 정렬,510,255,255,0.5
플래티넘 2,크누스 최적화,4,2,2,0.5
플래티넘 2,3차원 기하학,32,16,16,0.5
플래티넘 2,이분 매칭,697,348,349,0.49928263988522237
플래티넘 2,두 포인터,945,471,474,0.4984126984126984
플래티넘 2,다이나믹 프로그래밍,6381,3160,3221,0.4952201849239931
플래티넘 2,회전하는 캘리퍼스,103,51,52,0.49514563106796117
플래티넘 2,너비 우선 탐색,3502,1728,1774,0.4934323243860651
플래티넘 2,런타임 전의 전처리,98,48,50,0.4897959183673469
플래티넘 2,큰 수 연산,474,231,243,0.4873417721518987
플래티넘 2,임의 정밀도,474,231,243,0.4873417721518987
플래티넘 2,비트필드를 이용한 다이나믹 프로그래밍,460,224,236,0.48695652173913045
플래티넘 2,0-1 너비 우선 탐색,148,72,76,0.4864864864864865
플래티넘 2,트리를 사용한 집합과 맵,403,195,208,0.4838709677419355
플래티넘 2,애드 혹,880,425,455,0.48295454545454547
플래티넘 2,누적 합,1071,515,556,0.480859010270775
플래티넘 2,소수 판정,1030,494,536,0.4796116504854369
플래티넘 2,트리에서의 다이나믹 프로그래밍,326,156,170,0.4785276073619632
플래티넘 2,그래프 탐색,5360,2557,2803,0.47705223880597014
플래티넘 2,값,232,110,122,0.47413793103448276
플래티넘 2,좌표 압축,232,110,122,0.47413793103448276
플래티넘 2,접미사 배열과 lcp 배열,108,51,57,0.4722222222222222
플래티넘 2,자료 구조,7605,3571,4034,0.4695595003287311
플래티넘 2,그래프 이론,8761,4111,4650,0.46923867138454517
플래티넘 2,그리디 알고리즘,3110,1442,1668,0.46366559485530545
플래티넘 2,기하학,1821,844,977,0.4634816035145524
플래티넘 2,트리,1957,907,1050,0.4634644864588656
플래티넘 2,단절점과 단절선,78,36,42,0.46153846153846156
플래티넘 2,파싱,373,171,202,0.4584450402144772
플래티넘 2,정수론,2767,1264,1503,0.45681243223707985
플래티넘 2,kmp,407,184,223,0.4520884520884521
플래티넘 2,최소 비용 최대 유량,129,58,71,0.4496124031007752
플래티넘 2,mo's,123,55,68,0.44715447154471544
플래티넘 2,이분 탐색,2505,1112,1393,0.4439121756487026
플래티넘 2,매내처,61,27,34,0.4426229508196721
플래티넘 2,분리 집합,1016,449,567,0.4419291338582677
플래티넘 2,연결 리스트,87,38,49,0.4367816091954023
플래티넘 2,비둘기집 원리,39,17,22,0.4358974358974359
플래티넘 2,구성적,522,227,295,0.43486590038314177
플래티넘 2,세그먼트 트리,2833,1226,1607,0.43275679491704905
플래티넘 2,오일러 피 함수,93,40,53,0.43010752688172044
플래티넘 2,양방향 탐색,7,3,4,0.42857142857142855
플래티넘 2,병렬 이분 탐색,14,6,8,0.42857142857142855
플래티넘 2,우선순위 큐,950,407,543,0.4284210526315789
플래티넘 2,뤼카 정리,26,11,15,0.4230769230769231
플래티넘 2,2-sat,192,81,111,0.421875
플래티넘 2,포함 배제의 원리,122,51,71,0.4180327868852459
플래티넘 2,매개 변수 탐색,513,214,299,0.4171539961013645
플래티넘 2,강한 연결 요소,492,205,287,0.4166666666666667
플래티넘 2,라빈–카프,58,24,34,0.41379310344827586
플래티넘 2,z,42,17,25,0.40476190476190477
플래티넘 2,트라이,377,152,225,0.40318302387267907
플래티넘 2,볼록 껍질,486,195,291,0.4012345679012346
플래티넘 2,다익스트라,1576,627,949,0.39784263959390864
플래티넘 2,스위핑,557,221,336,0.39676840215439857
플래티넘 2,아호-코라식,61,24,37,0.39344262295081966
플래티넘 2,오프라인 쿼리,315,122,193,0.3873015873015873
플래티넘 2,폴라드 로,124,48,76,0.3870967741935484
플래티넘 2,외판원 순회 문제,119,46,73,0.3865546218487395
플래티넘 2,배낭 문제,511,197,314,0.38551859099804303
플래티넘 2,미적분학,45,17,28,0.37777777777777777
플래티넘 2,밀러–라빈 소수 판별법,153,57,96,0.37254901960784315
플래티넘 2,중간에서 만나기,210,78,132,0.37142857142857144
플래티넘 2,덱,324,120,204,0.37037037037037035
플래티넘 2,최대 유량,756,277,479,0.3664021164021164
플래티넘 2,다각형의 넓이,88,32,56,0.36363636363636365
플래티넘 2,많은 조건 분기,728,261,467,0.3585164835164835
플래티넘 2,오일러 경로 테크닉,164,58,106,0.35365853658536583
플래티넘 2,느리게 갱신되는 세그먼트 트리,688,238,450,0.34593023255813954
플래티넘 2,a*,3,1,2,0.3333333333333333
플래티넘 2,무작위화,57,19,38,0.3333333333333333
플래티넘 2,벨만–포드,188,62,126,0.32978723404255317
플래티넘 2,확장 유클리드 호제법,152,49,103,0.3223684210526316
플래티넘 2,덱을 이용한 다이나믹 프로그래밍,53,16,37,0.3018867924528302
플래티넘 2,고속 푸리에 변환,113,34,79,0.3008849557522124
플래티넘 2,선분 교차 판정,422,125,297,0.2962085308056872
플래티넘 2,볼록 다각형 내부의 점 판정,50,14,36,0.28
플래티넘 2,볼록 껍질을 이용한 최적화,114,30,84,0.2631578947368421
플래티넘 2,오일러 경로,128,33,95,0.2578125
플래티넘 2,퍼시스턴트 세그먼트 트리,63,16,47,0.25396825396825395
플래티넘 2,해싱,263,64,199,0.24334600760456274
플래티넘 2,제곱근 분할법,70,17,53,0.24285714285714285
플래티넘 2,중국인의 나머지 정리,85,20,65,0.23529411764705882
플래티넘 2,최대 유량 최소 컷 정리,121,28,93,0.23140495867768596
플래티넘 2,센트로이드,5,1,4,0.2
플래티넘 2,로프,5,1,4,0.2
플래티넘 2,가우스 소거법,15,3,12,0.2
플래티넘 2,스플레이 트리,5,1,4,0.2
플래티넘 2,다차원 세그먼트 트리,89,17,72,0.19101123595505617
플래티넘 2,heavy-light 분할,6,1,5,0.16666666666666666
플래티넘 2,수치해석,77,12,65,0.15584415584415584
플래티넘 2,삼분 탐색,64,4,60,0.0625
플래티넘 2,회문 트리,1,0,1,0.0
플래티넘 2,헝가리안,1,0,1,0.0
플래티넘 2,센트로이드 분할,4,0,4,0.0
플래티넘 3,분할 정복을 사용한 최적화,1,1,0,1.0
플래티넘 3,베이즈 정리,1,1,0,1.0
플래티넘 3,히르쉬버그,1,1,0,1.0
플래티넘 3,통계학,1,1,0,1.0
플래티넘 3,서큘레이션,1,1,0,1.0
플래티넘 3,양방향 탐색,1,1,0,1.0
플래티넘 3,스토어–바그너,2,2,0,1.0
플래티넘 3,함수 개형을 이용한 최적화,4,4,0,1.0
플래티넘 3,기댓값의 선형성,7,6,1,0.8571428571428571
플래티넘 3,오일러 지표 (χ=v-e+f),11,9,2,0.8181818181818182
플래티넘 3,휴리스틱,97,79,18,0.8144329896907216
플래티넘 3,사칙연산,3992,3143,849,0.7873246492985972
플래티넘 3,담금질 기법,56,43,13,0.7678571428571429
플래티넘 3,피타고라스 정리,190,140,50,0.7368421052631579
플래티넘 3,물리학,14,10,4,0.7142857142857143
플래티넘 3,최소 외접원,10,7,3,0.7
플래티넘 3,센트로이드,3,2,1,0.6666666666666666
플래티넘 3,연결 리스트,51,34,17,0.6666666666666666
플래티넘 3,mo's,15,10,5,0.6666666666666666
플래티넘 3,큐,293,195,98,0.6655290102389079
플래티넘 3,구현,11979,7854,4125,0.6556473829201102
플래티넘 3,재귀,736,479,257,0.6508152173913043
플래티넘 3,볼록 다각형 내부의 점 판정,40,26,14,0.65
플래티넘 3,비둘기집 원리,42,27,15,0.6428571428571429
플래티넘 3,수학,12901,8210,4691,0.6363847763739245
플래티넘 3,유클리드 호제법,386,242,144,0.6269430051813472
플래티넘 3,플로이드–와샬,552,340,212,0.6159420289855072
플래티넘 3,머지 소트 트리,52,32,20,0.6153846153846154
플래티넘 3,해시를 사용한 집합과 맵,830,509,321,0.6132530120481928
플래티넘 3,0-1 너비 우선 탐색,107,65,42,0.6074766355140186
플래티넘 3,에라토스테네스의 체,684,414,270,0.6052631578947368
플래티넘 3,시뮬레이션,2799,1694,1105,0.6052161486245088
플래티넘 3,모듈로 곱셈 역원,146,88,58,0.6027397260273972
플래티넘 3,확률론,85,51,34,0.6
플래티넘 3,게임 이론,398,236,162,0.592964824120603
플래티넘 3,z,22,13,9,0.5909090909090909
플래티넘 3,트리를 사용한 집합과 맵,539,318,221,0.5899814471243042
플래티넘 3,문자열,3976,2316,1660,0.5824949698189135
플래티넘 3,가장 긴 증가하는 부분 수열: o(n log n),399,232,167,0.581453634085213
플래티넘 3,조합론,1009,585,424,0.5797819623389494
플래티넘 3,스택,1188,688,500,0.5791245791245792
플래티넘 3,퍼시스턴트 세그먼트 트리,19,11,8,0.5789473684210527
플래티넘 3,이분 매칭,433,250,183,0.5773672055427251
플래티넘 3,최소 비용 최대 유량,47,27,20,0.574468085106383
플래티넘 3,선형대수학,110,63,47,0.5727272727272728
플래티넘 3,위상 정렬,611,349,262,0.5711947626841244
플래티넘 3,최소 스패닝 트리,663,378,285,0.5701357466063348
플래티넘 3,백트래킹,1634,924,710,0.565483476132191
플래티넘 3,비트 집합,16,9,7,0.5625
플래티넘 3,3차원 기하학,50,28,22,0.56
플래티넘 3,브루트포스 알고리즘,4566,2525,2041,0.553000438020149
플래티넘 3,분할 정복을 이용한 거듭제곱,842,464,378,0.5510688836104513
플래티넘 3,정렬,4083,2246,1837,0.5500857212833701
플래티넘 3,로프,22,12,10,0.5454545454545454
플래티넘 3,정수론,2683,1447,1236,0.5393216548639582
플래티넘 3,제곱근 분할법,13,7,6,0.5384615384615384
플래티넘 3,다이나믹 프로그래밍,7737,4158,3579,0.537417603722373
플래티넘 3,분할 정복,875,470,405,0.5371428571428571
플래티넘 3,비트마스킹,1089,580,509,0.5325987144168962
플래티넘 3,오일러 피 함수,77,41,36,0.5324675324675324
플래티넘 3,덱,318,169,149,0.5314465408805031
플래티넘 3,소수 판정,1058,562,496,0.5311909262759924
플래티넘 3,자료 구조,8629,4541,4088,0.5262486962568085
플래티넘 3,두 포인터,1284,672,612,0.5233644859813084
플래티넘 3,임의 정밀도,653,341,312,0.5222052067381318
플래티넘 3,큰 수 연산,653,341,312,0.5222052067381318
플래티넘 3,스프라그–그런디 정리,77,40,37,0.5194805194805194
플래티넘 3,그리디 알고리즘,3700,1915,1785,0.5175675675675676
플래티넘 3,트리에서의 다이나믹 프로그래밍,453,233,220,0.5143487858719646
플래티넘 3,최소 공통 조상,518,266,252,0.5135135135135135
플래티넘 3,세그먼트 트리,2769,1417,1352,0.5117370892018779
플래티넘 3,누적 합,1245,631,614,0.5068273092369477
플래티넘 3,깊이 우선 탐색,2778,1401,1377,0.5043196544276458
플래티넘 3,기하학,1931,971,960,0.502848265147592
플래티넘 3,우선순위 큐,1313,659,654,0.5019040365575019
플래티넘 3,이분 그래프,6,3,3,0.5
플래티넘 3,슬라이딩 윈도우,278,139,139,0.5
플래티넘 3,센트로이드 분할,2,1,1,0.5
플래티넘 3,정규 표현식,108,54,54,0.5
플래티넘 3,트리,2288,1143,1145,0.4995629370629371
플래티넘 3,그래프 이론,11166,5565,5601,0.4983879634605051
플래티넘 3,너비 우선 탐색,4665,2323,2342,0.4979635584137192
플래티넘 3,페르마의 소정리,153,76,77,0.49673202614379086
플래티넘 3,분리 집합,1055,523,532,0.4957345971563981
플래티넘 3,그래프 탐색,7174,3554,3620,0.49540005575689994
플래티넘 3,비트필드를 이용한 다이나믹 프로그래밍,542,268,274,0.4944649446494465
플래티넘 3,무작위화,43,21,22,0.4883720930232558
플래티넘 3,배낭 문제,517,252,265,0.4874274661508704
플래티넘 3,kmp,386,188,198,0.48704663212435234
플래티넘 3,애드 혹,763,371,392,0.48623853211009177
플래티넘 3,2-sat,237,114,123,0.4810126582278481
플래티넘 3,파싱,489,235,254,0.48057259713701433
플래티넘 3,강한 연결 요소,510,245,265,0.4803921568627451
플래티넘 3,매개 변수 탐색,637,302,335,0.4740973312401884
플래티넘 3,중국인의 나머지 정리,47,22,25,0.46808510638297873
플래티넘 3,느리게 갱신되는 세그먼트 트리,391,183,208,0.4680306905370844
플래티넘 3,포함 배제의 원리,77,36,41,0.4675324675324675
플래티넘 3,순열 사이클 분할,28,13,15,0.4642857142857143
플래티넘 3,구성적,618,286,332,0.4627831715210356
플래티넘 3,외판원 순회 문제,202,93,109,0.4603960396039604
플래티넘 3,희소 배열,479,220,259,0.4592901878914405
플래티넘 3,고속 푸리에 변환,98,45,53,0.45918367346938777
플래티넘 3,다각형의 넓이,109,50,59,0.45871559633027525
플래티넘 3,최대 유량,399,181,218,0.45363408521303256
플래티넘 3,좌표 압축,329,149,180,0.45288753799392095
플래티넘 3,값,329,149,180,0.45288753799392095
플래티넘 3,다차원 세그먼트 트리,42,19,23,0.4523809523809524
플래티넘 3,오프라인 쿼리,124,56,68,0.45161290322580644
플래티넘 3,다익스트라,1733,775,958,0.447201384881708
플래티넘 3,이분 탐색,3404,1509,1895,0.44330199764982375
플래티넘 3,병렬 이분 탐색,16,7,9,0.4375
플래티넘 3,회전하는 캘리퍼스,83,36,47,0.43373493975903615
플래티넘 3,벌래캠프–매시,7,3,4,0.42857142857142855
플래티넘 3,뤼카 정리,50,21,29,0.42
플래티넘 3,트라이,335,139,196,0.41492537313432837
플래티넘 3,스위핑,661,270,391,0.4084720121028744
플래티넘 3,볼록 껍질,426,171,255,0.4014084507042254
플래티넘 3,매내처,20,8,12,0.4
플래티넘 3,오목 다각형 내부의 점 판정,5,2,3,0.4
플래티넘 3,확장 유클리드 호제법,60,24,36,0.4
플래티넘 3,미적분학,65,26,39,0.4
플래티넘 3,스플레이 트리,28,11,17,0.39285714285714285
플래티넘 3,중간에서 만나기,495,190,305,0.3838383838383838
플래티넘 3,많은 조건 분기,809,304,505,0.3757725587144623
플래티넘 3,단절점과 단절선,94,35,59,0.3723404255319149
플래티넘 3,선분 교차 판정,423,153,270,0.3617021276595745
플래티넘 3,런타임 전의 전처리,184,65,119,0.3532608695652174
플래티넘 3,최대 유량 최소 컷 정리,49,17,32,0.3469387755102041
플래티넘 3,덱을 이용한 다이나믹 프로그래밍,32,11,21,0.34375
플래티넘 3,폴라드 로,53,18,35,0.33962264150943394
플래티넘 3,작은 집합에서 큰 집합으로 합치는 테크닉,12,4,8,0.3333333333333333
플래티넘 3,aliens 트릭,3,1,2,0.3333333333333333
플래티넘 3,오일러 경로 테크닉,81,26,55,0.32098765432098764
플래티넘 3,밀러–라빈 소수 판별법,138,43,95,0.3115942028985507
플래티넘 3,heavy-light 분할,56,17,39,0.30357142857142855
플래티넘 3,벨만–포드,342,102,240,0.2982456140350877
플래티넘 3,아호-코라식,48,13,35,0.2708333333333333
플래티넘 3,안정 결혼 문제,26,7,19,0.2692307692307692
플래티넘 3,볼록 껍질을 이용한 최적화,30,8,22,0.26666666666666666
플래티넘 3,삼분 탐색,43,10,33,0.23255813953488372
플래티넘 3,평면 그래프,9,2,7,0.2222222222222222
플래티넘 3,가우스 소거법,19,4,15,0.21052631578947367
플래티넘 3,뫼비우스 반전 공식,5,1,4,0.2
플래티넘 3,접미사 배열과 lcp 배열,117,23,94,0.19658119658119658
플래티넘 3,해싱,161,29,132,0.18012422360248448
플래티넘 3,오일러 경로,106,16,90,0.1509433962264151
플래티넘 3,라빈–카프,81,12,69,0.14814814814814814
플래티넘 3,선인장,7,1,6,0.14285714285714285
플래티넘 3,4차원 이상의 기하학,21,3,18,0.14285714285714285
플래티넘 3,오프라인 동적 연결성 판정,17,2,15,0.11764705882352941
플래티넘 3,이중 연결 요소,10,1,9,0.1
플래티넘 3,수치해석,125,10,115,0.08
플래티넘 3,이산 로그,14,1,13,0.07142857142857142
플래티넘 3,a*,1,0,1,0.0
플래티넘 3,크누스 최적화,1,0,1,0.0
플래티넘 4,평면 그래프,2,2,0,1.0
플래티넘 4,커넥션 프로파일을 이용한 다이나믹 프로그래밍,1,1,0,1.0
플래티넘 4,이산 로그,23,23,0,1.0
플래티넘 4,로프,3,3,0,1.0
플래티넘 4,heavy-light 분할,8,7,1,0.875
플래티넘 4,오일러 지표 (χ=v-e+f),19,15,4,0.7894736842105263
플래티넘 4,사칙연산,6657,5148,1509,0.7733213159080667
플래티넘 4,선인장,4,3,1,0.75
플래티넘 4,3차원 기하학,36,26,10,0.7222222222222222
플래티넘 4,분할 정복을 사용한 최적화,7,5,2,0.7142857142857143
플래티넘 4,피타고라스 정리,300,202,98,0.6733333333333333
플래티넘 4,구현,23412,15378,8034,0.6568426447975397
플래티넘 4,큐,704,460,244,0.6534090909090909
플래티넘 4,재귀,1784,1126,658,0.6311659192825112
플래티넘 4,수학,22244,13785,8459,0.6197176766768567
플래티넘 4,안정 결혼 문제,13,8,5,0.6153846153846154
플래티넘 4,유클리드 호제법,632,386,246,0.6107594936708861
플래티넘 4,문자열,8165,4966,3199,0.6082057562767912
플래티넘 4,오목 다각형 내부의 점 판정,5,3,2,0.6
플래티넘 4,페르마의 소정리,275,165,110,0.6
플래티넘 4,모듈로 곱셈 역원,253,151,102,0.5968379446640316
플래티넘 4,해시를 사용한 집합과 맵,1806,1069,737,0.5919158361018826
플래티넘 4,비둘기집 원리,43,25,18,0.5813953488372093
플래티넘 4,시뮬레이션,6408,3721,2687,0.5806803995006242
플래티넘 4,플로이드–와샬,1617,934,683,0.577612863327149
플래티넘 4,가장 긴 증가하는 부분 수열: o(n log n),992,570,422,0.5745967741935484
플래티넘 4,에라토스테네스의 체,1170,666,504,0.5692307692307692
플래티넘 4,브루트포스 알고리즘,9688,5467,4221,0.5643063583815029
플래티넘 4,게임 이론,641,360,281,0.5616224648985959
플래티넘 4,백트래킹,4844,2714,2130,0.5602807597027251
플래티넘 4,최소 스패닝 트리,2019,1125,894,0.5572065378900446
플래티넘 4,작은 집합에서 큰 집합으로 합치는 테크닉,9,5,4,0.5555555555555556
플래티넘 4,위상 정렬,1722,944,778,0.5481997677119629
플래티넘 4,큰 수 연산,1149,629,520,0.5474325500435161
플래티넘 4,임의 정밀도,1149,629,520,0.5474325500435161
플래티넘 4,순열 사이클 분할,87,47,40,0.5402298850574713
플래티넘 4,스택,2836,1529,1307,0.5391396332863188
플래티넘 4,정수론,4261,2273,1988,0.5334428537901901
플래티넘 4,소수 판정,1704,906,798,0.5316901408450704
플래티넘 4,가우스 소거법,17,9,8,0.5294117647058824
플래티넘 4,슬라이딩 윈도우,631,334,297,0.5293185419968305
플래티넘 4,선형대수학,256,135,121,0.52734375
플래티넘 4,조합론,2149,1132,1017,0.5267566309911587
플래티넘 4,희소 배열,746,392,354,0.5254691689008043
플래티넘 4,정렬,8660,4542,4118,0.5244803695150115
플래티넘 4,머지 소트 트리,67,35,32,0.5223880597014925
플래티넘 4,파싱,859,446,413,0.519208381839348
플래티넘 4,그리디 알고리즘,7038,3642,3396,0.5174765558397272
플래티넘 4,다이나믹 프로그래밍,17292,8888,8404,0.5139949109414759
플래티넘 4,누적 합,2471,1269,1202,0.5135572642654795
플래티넘 4,덱,761,390,371,0.5124835742444153
플래티넘 4,회전하는 캘리퍼스,139,71,68,0.5107913669064749
플래티넘 4,분할 정복을 이용한 거듭제곱,1389,705,684,0.5075593952483801
플래티넘 4,폴라드 로,67,34,33,0.5074626865671642
플래티넘 4,트리,4679,2360,2319,0.5043812780508655
플래티넘 4,트리에서의 다이나믹 프로그래밍,915,460,455,0.5027322404371585
플래티넘 4,트리를 사용한 집합과 맵,869,435,434,0.5005753739930955
플래티넘 4,담금질 기법,2,1,1,0.5
플래티넘 4,함수 개형을 이용한 최적화,2,1,1,0.5
플래티넘 4,고속 푸리에 변환,114,57,57,0.5
플래티넘 4,z,14,7,7,0.5
플래티넘 4,배낭 문제,1189,594,595,0.49957947855340623
플래티넘 4,최소 공통 조상,949,473,476,0.49841938883034775
플래티넘 4,오일러 피 함수,189,94,95,0.4973544973544973
플래티넘 4,스프라그–그런디 정리,169,84,85,0.4970414201183432
플래티넘 4,자료 구조,17981,8937,9044,0.49702463711695677
플래티넘 4,깊이 우선 탐색,6581,3245,3336,0.49308615711897885
플래티넘 4,단절점과 단절선,203,100,103,0.49261083743842365
플래티넘 4,너비 우선 탐색,11610,5683,5927,0.48949181739879416
플래티넘 4,분할 정복,2005,981,1024,0.48927680798004985
플래티넘 4,그래프 탐색,17509,8477,9032,0.4841510080530013
플래티넘 4,연결 리스트,184,89,95,0.483695652173913
플래티넘 4,그래프 이론,27907,13461,14446,0.4823520980399183
플래티넘 4,정규 표현식,270,130,140,0.48148148148148145
플래티넘 4,비트마스킹,2659,1280,1379,0.4813839789394509
플래티넘 4,벌래캠프–매시,25,12,13,0.48
플래티넘 4,kmp,811,388,423,0.4784217016029593
플래티넘 4,비트 집합,23,11,12,0.4782608695652174
플래티넘 4,우선순위 큐,3116,1487,1629,0.47721437740693196
플래티넘 4,최대 유량 최소 컷 정리,19,9,10,0.47368421052631576
플래티넘 4,트라이,848,400,448,0.4716981132075472
플래티넘 4,구성적,645,304,341,0.47131782945736433
플래티넘 4,스플레이 트리,15,7,8,0.4666666666666667
플래티넘 4,두 포인터,3080,1437,1643,0.46655844155844156
플래티넘 4,오일러 경로 테크닉,50,23,27,0.46
플래티넘 4,세그먼트 트리,4329,1990,2339,0.4596904596904597
플래티넘 4,비트필드를 이용한 다이나믹 프로그래밍,1203,549,654,0.456359102244389
플래티넘 4,값,441,200,241,0.45351473922902497
플래티넘 4,좌표 압축,441,200,241,0.45351473922902497
플래티넘 4,분리 집합,2897,1310,1587,0.45219192267863306
플래티넘 4,덱을 이용한 다이나믹 프로그래밍,73,33,40,0.4520547945205479
플래티넘 4,애드 혹,1054,476,578,0.45161290322580644
플래티넘 4,기하학,3659,1622,2037,0.4432905165345723
플래티넘 4,2-sat,355,157,198,0.4422535211267606
플래티넘 4,강한 연결 요소,835,365,470,0.437125748502994
플래티넘 4,포함 배제의 원리,184,80,104,0.43478260869565216
플래티넘 4,외판원 순회 문제,496,215,281,0.4334677419354839
플래티넘 4,런타임 전의 전처리,206,89,117,0.4320388349514563
플래티넘 4,이분 매칭,533,230,303,0.43151969981238275
플래티넘 4,뤼카 정리,58,25,33,0.43103448275862066
플래티넘 4,이분 탐색,7114,3049,4065,0.4285915096991847
플래티넘 4,제곱근 분할법,33,14,19,0.42424242424242425
플래티넘 4,오프라인 쿼리,224,95,129,0.42410714285714285
플래티넘 4,매내처,38,16,22,0.42105263157894735
플래티넘 4,다익스트라,4903,2055,2848,0.41913114419743014
플래티넘 4,느리게 갱신되는 세그먼트 트리,461,193,268,0.41865509761388287
플래티넘 4,0-1 너비 우선 탐색,427,178,249,0.4168618266978923
플래티넘 4,mo's,87,36,51,0.41379310344827586
플래티넘 4,삼분 탐색,34,14,20,0.4117647058823529
플래티넘 4,매개 변수 탐색,1640,674,966,0.41097560975609754
플래티넘 4,중간에서 만나기,758,304,454,0.40105540897097625
플래티넘 4,확률론,179,70,109,0.39106145251396646
플래티넘 4,다각형의 넓이,255,97,158,0.3803921568627451
플래티넘 4,밀러–라빈 소수 판별법,154,58,96,0.37662337662337664
플래티넘 4,최소 비용 최대 유량,8,3,5,0.375
플래티넘 4,스위핑,1211,453,758,0.3740710156895128
플래티넘 4,중국인의 나머지 정리,127,47,80,0.3700787401574803
플래티넘 4,많은 조건 분기,1490,548,942,0.36778523489932885
플래티넘 4,최대 유량,324,117,207,0.3611111111111111
플래티넘 4,퍼시스턴트 세그먼트 트리,68,24,44,0.35294117647058826
플래티넘 4,선분 교차 판정,966,324,642,0.33540372670807456
플래티넘 4,아호-코라식,72,24,48,0.3333333333333333
플래티넘 4,볼록 껍질,699,224,475,0.32045779685264664
플래티넘 4,물리학,22,7,15,0.3181818181818182
플래티넘 4,볼록 껍질을 이용한 최적화,22,7,15,0.3181818181818182
플래티넘 4,벨만–포드,913,278,635,0.3044906900328587
플래티넘 4,수치해석,163,44,119,0.26993865030674846
플래티넘 4,미적분학,113,30,83,0.26548672566371684
플래티넘 4,접미사 배열과 lcp 배열,168,44,124,0.2619047619047619
플래티넘 4,볼록 다각형 내부의 점 판정,71,18,53,0.2535211267605634
플래티넘 4,이분 그래프,4,1,3,0.25
플래티넘 4,무작위화,40,10,30,0.25
플래티넘 4,휴리스틱,24,6,18,0.25
플래티넘 4,확장 유클리드 호제법,77,19,58,0.24675324675324675
플래티넘 4,다차원 세그먼트 트리,68,16,52,0.23529411764705882
플래티넘 4,최소 외접원,17,4,13,0.23529411764705882
플래티넘 4,a*,13,3,10,0.23076923076923078
플래티넘 4,기댓값의 선형성,32,7,25,0.21875
플래티넘 4,이중 연결 요소,14,3,11,0.21428571428571427
플래티넘 4,라빈–카프,108,21,87,0.19444444444444445
플래티넘 4,해싱,218,42,176,0.1926605504587156
플래티넘 4,오일러 경로,156,27,129,0.17307692307692307
플래티넘 4,병렬 이분 탐색,6,1,5,0.16666666666666666
플래티넘 4,베이즈 정리,19,3,16,0.15789473684210525
플래티넘 4,통계학,19,3,16,0.15789473684210525
플래티넘 4,양방향 탐색,7,1,6,0.14285714285714285
플래티넘 4,키타마사,10,1,9,0.1
플래티넘 4,춤추는 링크,2,0,2,0.0
플래티넘 4,크누스 x,2,0,2,0.0
플래티넘 4,🏃🤔,11,0,11,0.0
플래티넘 4,히르쉬버그,1,0,1,0.0
플래티넘 4,🧵,11,0,11,0.0
플래티넘 4,🌎👨‍💻📄🎱📖🧪,11,0,11,0.0
플래티넘 4,🧑‍💻,11,0,11,0.0
플래티넘 5,4차원 이상의 기하학,1,1,0,1.0
플래티넘 5,오일러 지표 (χ=v-e+f),26,26,0,1.0
플래티넘 5,최소 외접원,1,1,0,1.0
플래티넘 5,번사이드 보조정리,2,2,0,1.0
플래티넘 5,센트로이드,2,2,0,1.0
플래티넘 5,센트로이드 분할,2,2,0,1.0
플래티넘 5,a*,1,1,0,1.0
플래티넘 5,담금질 기법,48,44,4,0.9166666666666666
플래티넘 5,사칙연산,11498,8823,2675,0.7673508436249783
플래티넘 5,피타고라스 정리,450,340,110,0.7555555555555555
플래티넘 5,휴리스틱,65,47,18,0.7230769230769231
플래티넘 5,큐,1485,1066,419,0.7178451178451178
플래티넘 5,순열 사이클 분할,70,47,23,0.6714285714285714
플래티넘 5,병렬 이분 탐색,3,2,1,0.6666666666666666
플래티넘 5,인터프리터,3,2,1,0.6666666666666666
플래티넘 5,구현,46313,29126,17187,0.6288946947941183
플래티넘 5,utf-8 입력 처리,8,5,3,0.625
플래티넘 5,재귀,4264,2648,1616,0.6210131332082551
플래티넘 5,수학,40728,24607,16121,0.6041789432331566
플래티넘 5,그린 정리,5,3,2,0.6
플래티넘 5,문자열,14485,8580,5905,0.5923369002416292
플래티넘 5,플로이드–와샬,2994,1734,1260,0.5791583166332666
플래티넘 5,좌표 압축,563,325,238,0.5772646536412078
플래티넘 5,값,563,325,238,0.5772646536412078
플래티넘 5,양방향 탐색,7,4,3,0.5714285714285714
플래티넘 5,위상 정렬,2980,1689,1291,0.5667785234899329
플래티넘 5,가장 긴 증가하는 부분 수열: o(n log n),2249,1262,987,0.5611382836816363
플래티넘 5,해시를 사용한 집합과 맵,3486,1947,1539,0.5585197934595525
플래티넘 5,게임 이론,808,451,357,0.5581683168316832
플래티넘 5,백트래킹,11596,6450,5146,0.5562262849258365
플래티넘 5,시뮬레이션,12737,7072,5665,0.5552327863704168
플래티넘 5,오일러 피 함수,208,115,93,0.5528846153846154
플래티넘 5,유클리드 호제법,1243,682,561,0.5486725663716814
플래티넘 5,브루트포스 알고리즘,20998,11521,9477,0.5486713020287647
플래티넘 5,조합론,3946,2161,1785,0.5476431829700963
플래티넘 5,최소 스패닝 트리,3683,1993,1690,0.5411349443388542
플래티넘 5,작은 집합에서 큰 집합으로 합치는 테크닉,13,7,6,0.5384615384615384
플래티넘 5,분할 정복,3396,1806,1590,0.5318021201413428
플래티넘 5,heavy-light 분할,17,9,8,0.5294117647058824
플래티넘 5,에라토스테네스의 체,2888,1516,1372,0.5249307479224377
플래티넘 5,덱을 이용한 다이나믹 프로그래밍,21,11,10,0.5238095238095238
플래티넘 5,스택,5490,2875,2615,0.52367941712204
플래티넘 5,소수 판정,3745,1935,1810,0.5166889185580774
플래티넘 5,정렬,16885,8689,8196,0.5145987562925673
플래티넘 5,모듈로 곱셈 역원,512,263,249,0.513671875
플래티넘 5,정규 표현식,351,180,171,0.5128205128205128
플래티넘 5,정수론,8282,4221,4061,0.5096595025356194
플래티넘 5,다이나믹 프로그래밍,32772,16681,16091,0.5090015867203711
플래티넘 5,무작위화,109,55,54,0.5045871559633027
플래티넘 5,덱,1573,792,781,0.5034965034965035
플래티넘 5,배낭 문제,2330,1167,1163,0.5008583690987124
플래티넘 5,이분 그래프,4,2,2,0.5
플래티넘 5,퍼시스턴트 세그먼트 트리,2,1,1,0.5
플래티넘 5,이중 연결 요소,2,1,1,0.5
플래티넘 5,선인장,2,1,1,0.5
플래티넘 5,그리디 알고리즘,13511,6743,6768,0.49907482791799274
플래티넘 5,3차원 기하학,95,47,48,0.49473684210526314
플래티넘 5,비트마스킹,4033,1995,2038,0.49466898090751305
플래티넘 5,페르마의 소정리,478,236,242,0.49372384937238495
플래티넘 5,파싱,1873,924,949,0.49332621462893755
플래티넘 5,깊이 우선 탐색,14182,6990,7192,0.492878296432097
플래티넘 5,트리에서의 다이나믹 프로그래밍,1240,610,630,0.49193548387096775
플래티넘 5,슬라이딩 윈도우,1251,610,641,0.4876099120703437
플래티넘 5,연결 리스트,417,203,214,0.486810551558753
플래티넘 5,자료 구조,30335,14750,15585,0.4862370199439591
플래티넘 5,트리,7730,3740,3990,0.48382923673997413
플래티넘 5,단절점과 단절선,120,58,62,0.48333333333333334
플래티넘 5,누적 합,4010,1920,2090,0.47880299251870323
플래티넘 5,너비 우선 탐색,26458,12596,13862,0.47607528913750097
플래티넘 5,트리를 사용한 집합과 맵,1934,918,1016,0.47466390899689764
플래티넘 5,그래프 이론,55098,26067,29031,0.47310247195905475
플래티넘 5,선형대수학,480,227,253,0.47291666666666665
플래티넘 5,폴라드 로,108,51,57,0.4722222222222222
플래티넘 5,트라이,833,393,440,0.4717887154861945
플래티넘 5,그래프 탐색,37429,17581,19848,0.4697159956183708
플래티넘 5,비둘기집 원리,62,29,33,0.46774193548387094
플래티넘 5,임의 정밀도,2713,1262,1451,0.46516771102100996
플래티넘 5,큰 수 연산,2713,1262,1451,0.46516771102100996
플래티넘 5,분할 정복을 이용한 거듭제곱,2451,1138,1313,0.46430028559771525
플래티넘 5,밀러–라빈 소수 판별법,162,75,87,0.46296296296296297
플래티넘 5,기하학,5153,2380,2773,0.46186687366582574
플래티넘 5,두 포인터,6245,2881,3364,0.46132906325060047
플래티넘 5,볼록 껍질을 이용한 최적화,37,17,20,0.4594594594594595
플래티넘 5,희소 배열,996,457,539,0.45883534136546184
플래티넘 5,세그먼트 트리,4632,2119,2513,0.4574697754749568
플래티넘 5,머지 소트 트리,90,41,49,0.45555555555555555
플래티넘 5,크누스 최적화,11,5,6,0.45454545454545453
플래티넘 5,런타임 전의 전처리,240,109,131,0.45416666666666666
플래티넘 5,이분 매칭,677,307,370,0.4534711964549483
플래티넘 5,우선순위 큐,6112,2736,3376,0.4476439790575916
플래티넘 5,함수 개형을 이용한 최적화,18,8,10,0.4444444444444444
플래티넘 5,비트 집합,45,20,25,0.4444444444444444
플래티넘 5,확률론,254,112,142,0.4409448818897638
플래티넘 5,비트필드를 이용한 다이나믹 프로그래밍,1223,539,684,0.44071954210956665
플래티넘 5,스프라그–그런디 정리,143,63,80,0.4405594405594406
플래티넘 5,확장 유클리드 호제법,142,62,80,0.43661971830985913
플래티넘 5,라빈–카프,39,17,22,0.4358974358974359
플래티넘 5,애드 혹,1355,588,767,0.43394833948339484
플래티넘 5,최소 공통 조상,1424,613,811,0.43047752808988765
플래티넘 5,kmp,1075,457,618,0.42511627906976746
플래티넘 5,이분 탐색,13354,5633,7721,0.42182117717537815
플래티넘 5,다익스트라,9049,3812,5237,0.42126201790253065
플래티넘 5,매개 변수 탐색,3260,1366,1894,0.4190184049079755
플래티넘 5,2-sat,86,36,50,0.4186046511627907
플래티넘 5,삼분 탐색,60,25,35,0.4166666666666667
플래티넘 5,0-1 너비 우선 탐색,1053,436,617,0.4140550807217474
플래티넘 5,외판원 순회 문제,866,357,509,0.4122401847575058
플래티넘 5,접미사 배열과 lcp 배열,68,28,40,0.4117647058823529
플래티넘 5,매내처,39,16,23,0.41025641025641024
플래티넘 5,분리 집합,5297,2151,3146,0.4060789125920332
플래티넘 5,미적분학,232,94,138,0.4051724137931034
플래티넘 5,느리게 갱신되는 세그먼트 트리,412,165,247,0.40048543689320387
플래티넘 5,포함 배제의 원리,170,68,102,0.4
플래티넘 5,오프라인 쿼리,221,85,136,0.38461538461538464
플래티넘 5,스위핑,1257,478,779,0.38027048528241847
플래티넘 5,강한 연결 요소,374,142,232,0.37967914438502676
플래티넘 5,가우스 소거법,40,15,25,0.375
플래티넘 5,구성적,785,292,493,0.3719745222929936
플래티넘 5,최대 유량,335,122,213,0.3641791044776119
플래티넘 5,다각형의 넓이,546,197,349,0.3608058608058608
플래티넘 5,중간에서 만나기,1093,380,713,0.34766697163769444
플래티넘 5,안정 결혼 문제,26,9,17,0.34615384615384615
플래티넘 5,고속 푸리에 변환,81,28,53,0.345679012345679
플래티넘 5,기댓값의 선형성,35,12,23,0.34285714285714286
플래티넘 5,볼록 다각형 내부의 점 판정,62,21,41,0.3387096774193548
플래티넘 5,많은 조건 분기,2352,786,1566,0.33418367346938777
플래티넘 5,춤추는 링크,3,1,2,0.3333333333333333
플래티넘 5,크누스 x,3,1,2,0.3333333333333333
플래티넘 5,mo's,125,41,84,0.328
플래티넘 5,아호-코라식,58,19,39,0.3275862068965517
플래티넘 5,뤼카 정리,166,54,112,0.3253012048192771
플래티넘 5,z,32,10,22,0.3125
플래티넘 5,선분 교차 판정,1250,386,864,0.3088
플래티넘 5,최대 유량 최소 컷 정리,13,4,9,0.3076923076923077
플래티넘 5,중국인의 나머지 정리,361,111,250,0.3074792243767313
플래티넘 5,벨만–포드,1555,475,1080,0.3054662379421222
플래티넘 5,볼록 껍질,476,144,332,0.3025210084033613
플래티넘 5,오일러 경로 테크닉,40,12,28,0.3
플래티넘 5,다차원 세그먼트 트리,55,16,39,0.2909090909090909
플래티넘 5,제곱근 분할법,31,9,22,0.2903225806451613
플래티넘 5,물리학,84,24,60,0.2857142857142857
플래티넘 5,분할 정복을 사용한 최적화,49,14,35,0.2857142857142857
플래티넘 5,히르쉬버그,8,2,6,0.25
플래티넘 5,생성 함수,4,1,3,0.25
플래티넘 5,최소 비용 최대 유량,8,2,6,0.25
플래티넘 5,회전하는 캘리퍼스,115,28,87,0.24347826086956523
플래티넘 5,오일러 경로,111,26,85,0.23423423423423423
플래티넘 5,수치해석,837,154,683,0.18399044205495818
플래티넘 5,오목 다각형 내부의 점 판정,6,1,5,0.16666666666666666
플래티넘 5,해싱,192,31,161,0.16145833333333334
플래티넘 5,유향 최소 신장 트리,16,2,14,0.125
플래티넘 5,🧵,3,0,3,0.0
플래티넘 5,🏃🤔,3,0,3,0.0
플래티넘 5,🧑‍💻,3,0,3,0.0
플래티넘 5,현 그래프,92,0,92,0.0
플래티넘 5,스플레이 트리,1,0,1,0.0
플래티넘 5,🌎👨‍💻📄🎱📖🧪,3,0,3,0.0
플래티넘 5,서큘레이션,3,0,3,0.0
